OA,ts0080001,ts0080002,ts0080003,ts0080002_PCT,ts0080003_PCT
E00052692,432,232,200,53.70370370370371,46.2962962962963
E00052702,268,129,139,48.134328358208954,51.865671641791046
E00052703,290,156,134,53.79310344827586,46.206896551724135
E00052706,288,147,141,51.041666666666664,48.95833333333333
E00052707,484,239,245,49.3801652892562,50.6198347107438
E00052693,310,162,148,52.25806451612903,47.74193548387097
E00052711,306,157,149,51.307189542483655,48.69281045751634
E00052712,244,128,116,52.459016393442624,47.540983606557376
E00052716,277,139,138,50.18050541516246,49.81949458483754
E00052717,295,141,154,47.79661016949153,52.20338983050847
E00052713,236,126,110,53.38983050847458,46.61016949152542
E00052714,309,157,152,50.80906148867314,49.19093851132686
E00052715,299,151,148,50.50167224080268,49.49832775919732
E00052718,308,160,148,51.94805194805194,48.05194805194805
E00052690,249,118,131,47.389558232931726,52.610441767068274
E00052695,231,120,111,51.94805194805194,48.05194805194805
E00052719,326,168,158,51.533742331288344,48.466257668711656
E00052720,321,160,161,49.84423676012461,50.155763239875384
E00052724,281,150,131,53.380782918149464,46.619217081850536
E00052694,266,131,135,49.24812030075188,50.75187969924813
E00052696,445,232,213,52.13483146067416,47.86516853932584
E00052721,373,193,180,51.742627345844504,48.257372654155496
E00052722,296,164,132,55.4054054054054,44.5945945945946
E00052697,360,193,167,53.61111111111111,46.38888888888889
E00052698,283,157,126,55.47703180212014,44.522968197879855
E00052700,342,189,153,55.26315789473685,44.73684210526316
E00052723,332,174,158,52.40963855421686,47.59036144578313
E00052725,276,137,139,49.63768115942029,50.36231884057971
E00052691,286,144,142,50.349650349650354,49.65034965034965
E00052699,404,216,188,53.46534653465347,46.53465346534654
E00052701,364,194,170,53.2967032967033,46.7032967032967
E00052704,302,149,153,49.337748344370866,50.66225165562914
E00052994,296,151,145,51.01351351351351,48.986486486486484
E00053003,333,177,156,53.153153153153156,46.846846846846844
E00053025,266,134,132,50.37593984962406,49.62406015037594
E00053026,246,127,119,51.6260162601626,48.3739837398374
E00053028,335,168,167,50.14925373134328,49.850746268656714
E00053029,271,139,132,51.291512915129154,48.708487084870846
E00052993,318,154,164,48.42767295597484,51.57232704402516
E00053001,234,112,122,47.863247863247864,52.13675213675214
E00053023,271,129,142,47.601476014760145,52.398523985239855
E00053024,289,139,150,48.09688581314879,51.903114186851205
E00052996,337,178,159,52.818991097922854,47.18100890207715
E00052999,345,175,170,50.72463768115942,49.275362318840585
E00053009,384,211,173,54.947916666666664,45.05208333333333
E00053027,404,203,201,50.24752475247525,49.75247524752475
E00052991,378,192,186,50.79365079365079,49.2063492063492
E00053005,284,161,123,56.690140845070424,43.309859154929576
E00053007,417,234,183,56.11510791366906,43.884892086330936
E00053010,383,207,176,54.04699738903395,45.95300261096606
E00052990,280,144,136,51.42857142857142,48.57142857142857
E00052995,375,215,160,57.333333333333336,42.66666666666667
E00053000,261,141,120,54.02298850574713,45.97701149425287
E00053004,200,110,90,55.00000000000001,45
E00053030,290,150,140,51.724137931034484,48.275862068965516
E00052989,279,150,129,53.76344086021505,46.236559139784944
E00052997,242,123,119,50.82644628099173,49.17355371900827
E00053002,277,133,144,48.014440433213,51.985559566786996
E00053006,233,118,115,50.64377682403433,49.35622317596567
E00053008,305,160,145,52.459016393442624,47.540983606557376
E00053230,300,157,143,52.33333333333333,47.66666666666667
E00053231,303,162,141,53.46534653465347,46.53465346534654
E00053233,240,107,133,44.583333333333336,55.41666666666667
E00053234,319,161,158,50.470219435736674,49.52978056426332
E00053235,232,114,118,49.137931034482754,50.86206896551724
E00053204,300,157,143,52.33333333333333,47.66666666666667
E00053232,310,156,154,50.32258064516129,49.67741935483871
E00053236,292,155,137,53.082191780821915,46.917808219178085
E00053237,272,160,112,58.82352941176471,41.17647058823529
E00053238,243,123,120,50.617283950617285,49.382716049382715
E00052803,366,198,168,54.09836065573771,45.90163934426229
E00052805,401,196,205,48.87780548628429,51.12219451371571
E00052829,403,229,174,56.82382133995038,43.17617866004963
E00052831,316,176,140,55.69620253164557,44.303797468354425
E00052798,350,162,188,46.285714285714285,53.714285714285715
E00052800,338,184,154,54.437869822485204,45.562130177514796
E00052801,332,175,157,52.71084337349398,47.28915662650602
E00052802,262,130,132,49.61832061068702,50.38167938931297
E00052827,307,144,163,46.90553745928339,53.09446254071661
E00052797,347,189,158,54.46685878962536,45.53314121037464
E00052825,344,175,169,50.872093023255815,49.127906976744185
E00052826,332,168,164,50.602409638554214,49.39759036144578
E00052828,307,172,135,56.02605863192183,43.97394136807817
E00052830,362,187,175,51.657458563535904,48.34254143646409
E00052912,457,240,217,52.516411378555794,47.4835886214442
E00052917,354,200,154,56.49717514124294,43.50282485875706
E00052927,376,194,182,51.59574468085106,48.40425531914894
E00052928,319,169,150,52.97805642633229,47.02194357366771
E00053283,264,128,136,48.484848484848484,51.515151515151516
E00053305,253,130,123,51.38339920948617,48.616600790513836
E00053306,289,155,134,53.63321799307958,46.36678200692042
E00053308,190,98,92,51.578947368421055,48.421052631578945
E00053310,255,136,119,53.333333333333336,46.666666666666664
E00053313,248,136,112,54.83870967741935,45.16129032258064
E00053288,293,155,138,52.901023890784984,47.098976109215016
E00053302,286,146,140,51.048951048951054,48.95104895104895
E00053303,266,129,137,48.49624060150376,51.50375939849624
E00053307,325,159,166,48.92307692307693,51.07692307692307
E00053309,255,126,129,49.411764705882355,50.588235294117645
E00053280,308,154,154,50,50
E00053281,298,148,150,49.664429530201346,50.33557046979866
E00053285,228,115,113,50.43859649122807,49.56140350877193
E00053311,296,158,138,53.37837837837838,46.62162162162162
E00053314,294,152,142,51.70068027210885,48.29931972789115
E00053292,244,131,113,53.68852459016394,46.31147540983606
E00053293,276,139,137,50.36231884057971,49.63768115942029
E00053295,267,138,129,51.68539325842697,48.31460674157304
E00053296,325,170,155,52.307692307692314,47.69230769230769
E00053299,313,175,138,55.91054313099042,44.08945686900959
E00053294,279,132,147,47.31182795698925,52.68817204301075
E00053297,297,156,141,52.52525252525253,47.474747474747474
E00053298,267,144,123,53.93258426966292,46.06741573033708
E00053300,269,135,134,50.18587360594795,49.814126394052046
E00053301,320,167,153,52.1875,47.8125
E00053304,276,141,135,51.08695652173913,48.91304347826087
E00052992,356,179,177,50.28089887640449,49.71910112359551
E00052998,314,157,157,50,50
E00053012,289,152,137,52.595155709342556,47.40484429065744
E00053013,276,131,145,47.46376811594203,52.53623188405797
E00053016,209,114,95,54.54545454545454,45.45454545454545
E00053011,374,191,183,51.06951871657755,48.93048128342246
E00053014,314,160,154,50.955414012738856,49.044585987261144
E00053015,339,178,161,52.50737463126843,47.49262536873156
E00053018,356,180,176,50.56179775280899,49.43820224719101
E00053017,295,150,145,50.847457627118644,49.152542372881356
E00053019,284,156,128,54.929577464788736,45.07042253521127
E00053020,286,140,146,48.95104895104895,51.048951048951054
E00053021,171,80,91,46.783625730994146,53.216374269005854
E00053022,219,113,106,51.598173515981735,48.401826484018265
E00052709,429,230,199,53.613053613053616,46.386946386946384
E00181870,327,177,150,54.12844036697248,45.87155963302752
E00181886,287,150,137,52.264808362369344,47.73519163763066
E00181859,399,201,198,50.37593984962406,49.62406015037594
E00181861,336,157,179,46.726190476190474,53.273809523809526
E00181881,220,119,101,54.090909090909086,45.909090909090914
E00181897,233,109,124,46.78111587982833,53.21888412017167
E00181907,343,165,178,48.10495626822158,51.89504373177842
E00181913,408,214,194,52.450980392156865,47.549019607843135
E00181918,351,168,183,47.863247863247864,52.13675213675214
E00052918,261,130,131,49.808429118773944,50.191570881226056
E00052919,402,225,177,55.970149253731336,44.02985074626866
E00052921,398,223,175,56.03015075376885,43.969849246231156
E00052922,425,228,197,53.64705882352941,46.35294117647059
E00052920,410,232,178,56.58536585365853,43.41463414634146
E00052923,368,196,172,53.2608695652174,46.73913043478261
E00052924,349,188,161,53.86819484240688,46.13180515759313
E00052926,360,192,168,53.333333333333336,46.666666666666664
E00052925,347,191,156,55.04322766570605,44.95677233429395
E00052929,332,176,156,53.01204819277109,46.98795180722892
E00052931,342,183,159,53.50877192982456,46.49122807017544
E00052932,326,177,149,54.29447852760736,45.70552147239264
E00052930,615,332,283,53.98373983739837,46.016260162601625
E00052933,401,215,186,53.61596009975062,46.38403990024938
E00052940,287,149,138,51.91637630662021,48.08362369337979
E00167328,480,255,225,53.125,46.875
E00167329,413,215,198,52.05811138014528,47.94188861985472
E00052804,258,138,120,53.48837209302325,46.51162790697674
E00052807,297,159,138,53.535353535353536,46.464646464646464
E00052810,294,152,142,51.70068027210885,48.29931972789115
E00052811,271,147,124,54.24354243542435,45.75645756457565
E00052814,329,153,176,46.504559270516715,53.49544072948328
E00052815,302,155,147,51.324503311258276,48.675496688741724
E00052799,328,167,161,50.91463414634146,49.08536585365854
E00052806,346,168,178,48.554913294797686,51.445086705202314
E00052808,225,107,118,47.55555555555556,52.44444444444445
E00052809,350,179,171,51.142857142857146,48.857142857142854
E00052813,301,157,144,52.159468438538205,47.840531561461795
E00052817,255,127,128,49.80392156862745,50.19607843137255
E00052818,369,184,185,49.86449864498645,50.135501355013545
E00052822,310,158,152,50.967741935483865,49.03225806451613
E00052823,360,173,187,48.05555555555556,51.94444444444445
E00052824,292,157,135,53.76712328767124,46.23287671232877
E00052812,292,150,142,51.369863013698634,48.63013698630137
E00052816,316,155,161,49.050632911392405,50.9493670886076
E00052819,298,152,146,51.006711409395976,48.99328859060403
E00052820,313,160,153,51.118210862619804,48.881789137380196
E00052821,353,182,171,51.55807365439094,48.44192634560906
E00053331,311,164,147,52.73311897106109,47.266881028938904
E00053334,358,190,168,53.072625698324025,46.927374301675975
E00053335,280,150,130,53.57142857142857,46.42857142857143
E00053338,337,162,175,48.07121661721068,51.92878338278932
E00053340,339,188,151,55.45722713864307,44.54277286135693
E00053341,218,128,90,58.71559633027523,41.284403669724774
E00053220,348,184,164,52.87356321839081,47.12643678160919
E00053223,291,151,140,51.890034364261176,48.10996563573883
E00053224,352,190,162,53.97727272727273,46.02272727272727
E00053227,341,184,157,53.95894428152492,46.04105571847507
E00053229,237,123,114,51.89873417721519,48.10126582278481
E00053201,320,155,165,48.4375,51.5625
E00053218,338,182,156,53.84615384615385,46.15384615384615
E00053225,251,139,112,55.37848605577689,44.6215139442231
E00053226,249,129,120,51.80722891566265,48.19277108433735
E00053228,300,148,152,49.333333333333336,50.66666666666667
E00053205,319,174,145,54.54545454545454,45.45454545454545
E00053206,305,154,151,50.49180327868853,49.50819672131148
E00053210,272,136,136,50,50
E00053214,324,179,145,55.24691358024691,44.75308641975309
E00053217,380,193,187,50.78947368421053,49.21052631578947
E00053203,257,120,137,46.69260700389105,53.30739299610895
E00053207,310,171,139,55.16129032258065,44.83870967741935
E00053208,303,159,144,52.475247524752476,47.524752475247524
E00053209,329,161,168,48.93617021276596,51.06382978723404
E00053212,312,159,153,50.96153846153846,49.03846153846153
E00053211,293,147,146,50.170648464163826,49.829351535836174
E00053213,355,180,175,50.70422535211267,49.29577464788733
E00053215,342,166,176,48.53801169590643,51.461988304093566
E00053219,317,161,156,50.78864353312302,49.21135646687697
E00053221,374,195,179,52.139037433155075,47.860962566844925
E00053282,281,144,137,51.245551601423486,48.754448398576514
E00053289,294,152,142,51.70068027210885,48.29931972789115
E00053290,232,123,109,53.01724137931034,46.98275862068966
E00053291,317,157,160,49.52681388012618,50.473186119873816
E00053312,286,140,146,48.95104895104895,51.048951048951054
E00053278,357,180,177,50.42016806722689,49.57983193277311
E00053279,276,142,134,51.449275362318836,48.55072463768116
E00053284,303,153,150,50.495049504950494,49.504950495049506
E00053286,404,211,193,52.22772277227723,47.77227722772277
E00053287,297,141,156,47.474747474747474,52.52525252525253
E00053326,199,97,102,48.743718592964825,51.256281407035175
E00053328,306,156,150,50.98039215686274,49.01960784313725
E00053344,301,158,143,52.49169435215947,47.50830564784053
E00053345,247,129,118,52.226720647773284,47.77327935222672
E00053347,259,128,131,49.42084942084942,50.57915057915058
E00053348,231,120,111,51.94805194805194,48.05194805194805
E00053318,287,136,151,47.386759581881535,52.613240418118465
E00053337,280,155,125,55.35714285714286,44.642857142857146
E00053342,286,136,150,47.55244755244755,52.44755244755245
E00053346,261,140,121,53.63984674329502,46.36015325670498
E00053350,293,156,137,53.242320819112635,46.75767918088737
E00053332,255,118,137,46.27450980392157,53.72549019607843
E00053333,276,148,128,53.62318840579711,46.3768115942029
E00053336,329,187,142,56.838905775075986,43.161094224924014
E00053339,329,165,164,50.15197568389058,49.848024316109424
E00053343,342,155,187,45.32163742690059,54.67836257309941
E00052911,351,165,186,47.008547008547005,52.991452991452995
E00052915,361,167,194,46.26038781163435,53.73961218836565
E00052916,355,168,187,47.32394366197183,52.67605633802817
E00052945,389,191,198,49.10025706940874,50.899742930591266
E00052913,355,179,176,50.42253521126761,49.57746478873239
E00052936,513,269,244,52.436647173489284,47.563352826510716
E00052937,382,197,185,51.57068062827225,48.42931937172775
E00052939,377,189,188,50.132625994694955,49.86737400530504
E00052914,395,174,221,44.050632911392405,55.949367088607595
E00052944,345,172,173,49.85507246376812,50.14492753623189
E00052946,346,176,170,50.86705202312138,49.13294797687861
E00052947,312,141,171,45.19230769230769,54.807692307692314
E00052934,280,145,135,51.78571428571429,48.214285714285715
E00052935,321,166,155,51.71339563862928,48.28660436137071
E00052938,405,221,184,54.567901234567906,45.4320987654321
E00052941,306,154,152,50.326797385620914,49.673202614379086
E00052943,384,205,179,53.385416666666664,46.61458333333333
E00052875,349,191,158,54.72779369627507,45.27220630372493
E00052876,337,170,167,50.445103857566764,49.554896142433236
E00052882,357,190,167,53.221288515406165,46.778711484593835
E00052908,292,143,149,48.97260273972603,51.02739726027398
E00052909,324,171,153,52.77777777777778,47.22222222222222
E00053319,303,160,143,52.8052805280528,47.194719471947195
E00053320,385,202,183,52.467532467532465,47.53246753246753
E00053322,301,146,155,48.50498338870432,51.49501661129568
E00053349,283,149,134,52.65017667844523,47.349823321554766
E00053351,303,152,151,50.165016501650165,49.834983498349835
E00053315,326,161,165,49.38650306748466,50.61349693251533
E00053329,304,157,147,51.64473684210527,48.35526315789473
E00053330,317,143,174,45.110410094637224,54.889589905362776
E00167331,359,165,194,45.96100278551532,54.038997214484674
E00167342,375,181,194,48.266666666666666,51.733333333333334
E00181856,137,66,71,48.175182481751825,51.82481751824818
E00181903,589,318,271,53.98981324278438,46.01018675721562
E00181924,132,62,70,46.96969696969697,53.03030303030303
E00053316,323,155,168,47.987616099071204,52.012383900928796
E00053317,316,165,151,52.21518987341772,47.78481012658228
E00053321,289,152,137,52.595155709342556,47.40484429065744
E00053324,282,141,141,50,50
E00053327,344,173,171,50.2906976744186,49.7093023255814
E00053352,252,137,115,54.36507936507936,45.63492063492063
E00053126,333,150,183,45.04504504504504,54.95495495495496
E00053132,336,160,176,47.61904761904761,52.38095238095239
E00053155,342,178,164,52.046783625730995,47.953216374269005
E00053156,388,193,195,49.74226804123711,50.25773195876289
E00053157,354,160,194,45.19774011299435,54.80225988700565
E00053117,342,165,177,48.24561403508772,51.75438596491229
E00053121,422,190,232,45.023696682464454,54.976303317535546
E00053129,265,140,125,52.83018867924528,47.16981132075472
E00053133,354,169,185,47.740112994350284,52.259887005649716
E00053136,343,155,188,45.18950437317784,54.81049562682215
E00053115,369,190,179,51.490514905149055,48.509485094850945
E00053119,394,194,200,49.23857868020304,50.76142131979695
E00053120,260,108,152,41.53846153846154,58.46153846153847
E00053131,438,205,233,46.80365296803653,53.19634703196348
E00053158,334,168,166,50.29940119760479,49.700598802395206
E00053122,329,172,157,52.27963525835866,47.72036474164133
E00053124,470,215,255,45.744680851063826,54.25531914893617
E00053125,445,210,235,47.19101123595505,52.80898876404494
E00053135,606,303,303,50,50
E00053200,344,181,163,52.616279069767444,47.383720930232556
E00053202,378,190,188,50.264550264550266,49.735449735449734
E00053216,371,184,187,49.59568733153639,50.40431266846361
E00181849,417,212,205,50.83932853717026,49.16067146282973
E00181875,239,138,101,57.74058577405857,42.25941422594142
E00053241,353,175,178,49.57507082152974,50.42492917847026
E00053246,218,119,99,54.58715596330275,45.412844036697244
E00053247,231,126,105,54.54545454545454,45.45454545454545
E00053248,214,128,86,59.813084112149525,40.18691588785047
E00053250,218,109,109,50,50
E00053260,238,122,116,51.26050420168067,48.739495798319325
E00053249,266,143,123,53.75939849624061,46.2406015037594
E00053251,255,145,110,56.86274509803921,43.13725490196079
E00053253,276,150,126,54.347826086956516,45.65217391304348
E00053254,198,120,78,60.60606060606061,39.39393939393939
E00053255,231,125,106,54.112554112554115,45.887445887445885
E00053259,210,116,94,55.23809523809524,44.761904761904766
E00053256,274,139,135,50.72992700729927,49.27007299270073
E00053257,289,143,146,49.48096885813148,50.51903114186851
E00053258,323,165,158,51.08359133126935,48.91640866873065
E00053263,350,197,153,56.285714285714285,43.714285714285715
E00053267,285,152,133,53.333333333333336,46.666666666666664
E00053242,363,195,168,53.71900826446281,46.28099173553719
E00053243,290,143,147,49.310344827586206,50.689655172413794
E00053244,357,172,185,48.17927170868347,51.820728291316534
E00053245,334,166,168,49.700598802395206,50.29940119760479
E00053252,250,137,113,54.800000000000004,45.2
E00052872,401,193,208,48.12967581047381,51.87032418952619
E00052874,255,135,120,52.94117647058824,47.05882352941176
E00052883,217,124,93,57.14285714285714,42.857142857142854
E00052893,396,207,189,52.27272727272727,47.72727272727273
E00052894,323,158,165,48.91640866873065,51.08359133126935
E00052897,210,101,109,48.095238095238095,51.90476190476191
E00052873,466,234,232,50.21459227467812,49.78540772532189
E00052901,443,233,210,52.595936794582386,47.40406320541761
E00052902,330,174,156,52.72727272727272,47.27272727272727
E00181864,257,128,129,49.80544747081712,50.19455252918288
E00181869,432,244,188,56.481481481481474,43.51851851851852
E00181884,498,251,247,50.401606425702816,49.59839357429719
E00181891,226,124,102,54.86725663716814,45.13274336283185
E00052899,420,209,211,49.76190476190476,50.23809523809524
E00052900,201,84,117,41.7910447761194,58.2089552238806
E00052903,343,162,181,47.23032069970846,52.76967930029155
E00052904,407,202,205,49.631449631449634,50.368550368550366
E00052905,581,270,311,46.47160068846816,53.528399311531835
E00052906,179,70,109,39.10614525139665,60.893854748603346
E00052877,334,145,189,43.41317365269461,56.58682634730538
E00052878,360,185,175,51.388888888888886,48.61111111111111
E00052881,327,164,163,50.15290519877675,49.84709480122324
E00052907,279,139,140,49.82078853046595,50.179211469534046
E00052910,358,180,178,50.27932960893855,49.72067039106145
E00052880,364,190,174,52.197802197802204,47.8021978021978
E00052884,192,114,78,59.375,40.625
E00052887,210,105,105,50,50
E00052888,240,124,116,51.66666666666667,48.333333333333336
E00052890,171,79,92,46.198830409356724,53.80116959064327
E00052891,317,161,156,50.78864353312302,49.21135646687697
E00052895,462,238,224,51.515151515151516,48.484848484848484
E00052879,341,185,156,54.252199413489734,45.74780058651026
E00052885,383,184,199,48.04177545691906,51.958224543080945
E00052886,352,185,167,52.55681818181818,47.44318181818182
E00052889,281,148,133,52.66903914590747,47.330960854092524
E00052892,314,167,147,53.18471337579618,46.81528662420382
E00053118,308,142,166,46.103896103896105,53.896103896103895
E00053123,396,179,217,45.20202020202021,54.7979797979798
E00053127,433,215,218,49.65357967667436,50.34642032332564
E00053128,352,181,171,51.42045454545454,48.57954545454545
E00053116,304,146,158,48.026315789473685,51.973684210526315
E00053130,521,259,262,49.71209213051823,50.287907869481764
E00053137,348,161,187,46.264367816091955,53.735632183908045
E00053142,436,202,234,46.330275229357795,53.669724770642205
E00053145,293,134,159,45.73378839590443,54.26621160409556
E00053134,467,243,224,52.03426124197003,47.96573875802998
E00053140,304,159,145,52.30263157894737,47.69736842105263
E00053144,443,243,200,54.85327313769752,45.146726862302486
E00053148,394,169,225,42.89340101522843,57.10659898477157
E00053139,467,228,239,48.82226980728051,51.17773019271949
E00053146,447,188,259,42.05816554809844,57.94183445190156
E00053147,408,179,229,43.872549019607845,56.127450980392155
E00053149,423,182,241,43.02600472813239,56.973995271867615
E00053037,237,116,121,48.9451476793249,51.0548523206751
E00053070,230,104,126,45.21739130434783,54.78260869565217
E00053071,317,153,164,48.26498422712934,51.73501577287066
E00053072,312,155,157,49.67948717948718,50.32051282051282
E00053073,309,133,176,43.042071197411005,56.957928802588995
E00053075,148,60,88,40.54054054054054,59.45945945945946
E00053032,358,165,193,46.089385474860336,53.910614525139664
E00053063,412,170,242,41.262135922330096,58.7378640776699
E00053066,349,139,210,39.82808022922636,60.17191977077364
E00053068,229,88,141,38.427947598253276,61.572052401746724
E00053069,255,92,163,36.07843137254902,63.921568627450974
E00053033,228,122,106,53.50877192982456,46.49122807017544
E00053051,303,151,152,49.834983498349835,50.165016501650165
E00053052,246,133,113,54.0650406504065,45.9349593495935
E00053053,307,164,143,53.420195439739416,46.579804560260584
E00053054,187,88,99,47.05882352941176,52.94117647058824
E00053055,276,133,143,48.188405797101446,51.81159420289855
E00053034,306,168,138,54.90196078431373,45.09803921568628
E00053056,321,144,177,44.85981308411215,55.140186915887845
E00053057,354,187,167,52.824858757062145,47.175141242937855
E00053058,366,192,174,52.459016393442624,47.540983606557376
E00053059,445,210,235,47.19101123595505,52.80898876404494
E00053060,371,185,186,49.865229110512125,50.13477088948787
E00053061,322,181,141,56.2111801242236,43.7888198757764
E00053062,266,131,135,49.24812030075188,50.75187969924813
E00053064,154,67,87,43.506493506493506,56.493506493506494
E00053067,286,139,147,48.6013986013986,51.39860139860139
E00052730,284,148,136,52.112676056338024,47.88732394366197
E00052758,405,212,193,52.345679012345684,47.654320987654316
E00052759,343,171,172,49.85422740524781,50.14577259475219
E00052760,357,172,185,48.17927170868347,51.820728291316534
E00052741,304,167,137,54.93421052631579,45.06578947368421
E00052745,387,201,186,51.93798449612403,48.06201550387597
E00052748,316,168,148,53.16455696202531,46.835443037974684
E00052750,366,213,153,58.19672131147541,41.80327868852459
E00052751,318,159,159,50,50
E00052731,256,136,120,53.125,46.875
E00052733,224,114,110,50.89285714285714,49.107142857142854
E00052734,239,119,120,49.7907949790795,50.2092050209205
E00052736,307,156,151,50.814332247557005,49.185667752442995
E00052739,247,131,116,53.036437246963565,46.963562753036435
E00052732,414,208,206,50.24154589371981,49.75845410628019
E00052735,349,180,169,51.57593123209169,48.42406876790831
E00052740,352,170,182,48.29545454545455,51.70454545454546
E00052742,359,192,167,53.48189415041783,46.51810584958218
E00052726,398,192,206,48.24120603015075,51.75879396984925
E00052738,265,135,130,50.943396226415096,49.056603773584904
E00052743,198,103,95,52.02020202020202,47.97979797979798
E00052744,291,152,139,52.23367697594502,47.766323024054984
E00052746,340,164,176,48.23529411764706,51.76470588235295
E00052747,394,197,197,50,50
E00052729,220,118,102,53.63636363636364,46.36363636363636
E00052752,285,153,132,53.68421052631579,46.31578947368421
E00052753,356,195,161,54.7752808988764,45.2247191011236
E00052754,210,107,103,50.95238095238095,49.047619047619044
E00052755,310,153,157,49.354838709677416,50.645161290322584
E00052756,314,176,138,56.05095541401274,43.94904458598726
E00053042,287,147,140,51.21951219512195,48.78048780487805
E00053046,257,145,112,56.42023346303502,43.57976653696498
E00053047,221,105,116,47.511312217194565,52.488687782805435
E00053049,207,109,98,52.65700483091788,47.34299516908212
E00053050,246,134,112,54.47154471544715,45.52845528455284
E00053076,314,164,150,52.22929936305732,47.77070063694268
E00053239,353,172,181,48.725212464589234,51.27478753541076
E00053265,348,179,169,51.43678160919541,48.56321839080459
E00053269,300,156,144,52,48
E00053271,336,170,166,50.595238095238095,49.404761904761905
E00053272,318,167,151,52.51572327044025,47.48427672955975
E00053261,260,125,135,48.07692307692308,51.92307692307693
E00053262,260,114,146,43.84615384615385,56.15384615384615
E00053264,313,155,158,49.52076677316294,50.47923322683706
E00053266,225,115,110,51.11111111111111,48.888888888888886
E00053268,289,140,149,48.44290657439446,51.55709342560554
E00053270,242,131,111,54.132231404958674,45.867768595041326
E00053240,322,162,160,50.31055900621118,49.68944099378882
E00053273,324,176,148,54.32098765432099,45.67901234567901
E00053274,297,167,130,56.22895622895623,43.77104377104377
E00053275,301,160,141,53.156146179402,46.84385382059801
E00053276,303,163,140,53.79537953795379,46.2046204620462
E00053277,317,155,162,48.89589905362776,51.10410094637224
E00052836,391,226,165,57.8005115089514,42.19948849104859
E00052847,289,143,146,49.48096885813148,50.51903114186851
E00052848,306,148,158,48.366013071895424,51.633986928104584
E00052868,446,221,225,49.55156950672646,50.44843049327354
E00052871,410,198,212,48.292682926829265,51.707317073170735
E00052834,423,202,221,47.75413711583924,52.24586288416076
E00052860,204,88,116,43.13725490196079,56.86274509803921
E00052861,275,137,138,49.81818181818182,50.18181818181818
E00052864,368,197,171,53.53260869565217,46.46739130434783
E00052866,246,102,144,41.46341463414634,58.536585365853654
E00052869,112,60,52,53.57142857142857,46.42857142857143
E00052837,318,149,169,46.855345911949684,53.144654088050316
E00052838,333,150,183,45.04504504504504,54.95495495495496
E00052840,365,162,203,44.38356164383562,55.61643835616439
E00052841,369,187,182,50.67750677506775,49.32249322493225
E00052844,303,156,147,51.48514851485149,48.51485148514851
E00052832,450,226,224,50.22222222222222,49.77777777777778
E00052839,382,212,170,55.497382198952884,44.50261780104712
E00052842,357,181,176,50.700280112044815,49.299719887955185
E00052843,420,199,221,47.38095238095238,52.61904761904762
E00052835,269,126,143,46.84014869888476,53.159851301115246
E00052862,265,133,132,50.18867924528302,49.81132075471698
E00052863,189,72,117,38.095238095238095,61.904761904761905
E00052865,350,183,167,52.28571428571429,47.714285714285715
E00052867,519,258,261,49.71098265895954,50.28901734104046
E00053138,257,146,111,56.809338521400775,43.190661478599225
E00053141,330,175,155,53.03030303030303,46.96969696969697
E00167321,345,180,165,52.17391304347826,47.82608695652174
E00167346,265,138,127,52.075471698113205,47.924528301886795
E00181854,698,339,359,48.567335243553,51.43266475644699
E00167318,457,215,242,47.04595185995623,52.95404814004377
E00167325,198,71,127,35.858585858585855,64.14141414141415
E00167326,324,149,175,45.98765432098765,54.01234567901234
E00181922,301,139,162,46.179401993355484,53.820598006644516
E00052964,256,142,114,55.46875,44.53125
E00052970,321,165,156,51.4018691588785,48.598130841121495
E00052971,314,161,153,51.27388535031847,48.72611464968153
E00052972,337,173,164,51.33531157270029,48.6646884272997
E00052974,296,152,144,51.35135135135135,48.64864864864865
E00052950,292,143,149,48.97260273972603,51.02739726027398
E00052951,334,171,163,51.19760479041916,48.80239520958084
E00052967,234,129,105,55.12820512820513,44.871794871794876
E00052968,325,173,152,53.230769230769226,46.76923076923077
E00052975,277,141,136,50.90252707581227,49.09747292418773
E00052948,383,201,182,52.48041775456919,47.51958224543081
E00052959,295,137,158,46.440677966101696,53.559322033898304
E00052960,232,113,119,48.706896551724135,51.293103448275865
E00052961,347,181,166,52.1613832853026,47.83861671469741
E00052963,285,144,141,50.526315789473685,49.473684210526315
E00053031,591,293,298,49.57698815566836,50.42301184433165
E00053044,350,173,177,49.42857142857143,50.57142857142857
E00053065,257,133,124,51.75097276264592,48.249027237354085
E00053074,385,222,163,57.66233766233766,42.33766233766234
E00053035,364,175,189,48.07692307692308,51.92307692307693
E00053038,291,150,141,51.546391752577314,48.45360824742268
E00053040,307,159,148,51.79153094462541,48.20846905537459
E00053043,276,151,125,54.710144927536234,45.289855072463766
E00053036,272,134,138,49.26470588235294,50.73529411764706
E00053039,323,176,147,54.4891640866873,45.51083591331269
E00053041,259,139,120,53.66795366795367,46.33204633204633
E00053045,277,144,133,51.985559566786996,48.014440433213
E00053048,329,186,143,56.53495440729483,43.46504559270517
E00052614,327,168,159,51.37614678899083,48.62385321100918
E00052620,263,124,139,47.14828897338403,52.851711026615966
E00052625,316,158,158,50,50
E00052650,269,136,133,50.55762081784386,49.44237918215613
E00052655,315,161,154,51.11111111111111,48.888888888888886
E00052623,323,173,150,53.56037151702786,46.43962848297213
E00052630,346,182,164,52.601156069364166,47.398843930635834
E00052635,389,198,191,50.899742930591266,49.10025706940874
E00052636,332,176,156,53.01204819277109,46.98795180722892
E00052637,270,140,130,51.85185185185185,48.148148148148145
E00052619,392,203,189,51.78571428571429,48.214285714285715
E00052642,303,155,148,51.15511551155115,48.84488448844885
E00052643,215,117,98,54.418604651162795,45.58139534883721
E00052644,237,124,113,52.320675105485236,47.67932489451477
E00052647,178,86,92,48.31460674157304,51.68539325842697
E00052649,281,152,129,54.092526690391466,45.90747330960854
E00052621,339,162,177,47.78761061946903,52.21238938053098
E00052648,304,162,142,53.289473684210535,46.71052631578947
E00052652,309,162,147,52.42718446601942,47.57281553398058
E00052654,312,147,165,47.11538461538461,52.88461538461539
E00052656,290,150,140,51.724137931034484,48.275862068965516
E00052615,407,204,203,50.122850122850124,49.877149877149876
E00052616,305,159,146,52.131147540983605,47.868852459016395
E00052624,319,166,153,52.03761755485894,47.96238244514107
E00052628,304,151,153,49.67105263157895,50.32894736842105
E00052651,295,155,140,52.54237288135594,47.45762711864407
E00052617,420,219,201,52.142857142857146,47.85714285714286
E00052618,564,289,275,51.24113475177305,48.758865248226954
E00052632,392,183,209,46.683673469387756,53.316326530612244
E00052640,381,200,181,52.493438320209975,47.506561679790025
E00052626,288,162,126,56.25,43.75
E00052627,344,179,165,52.03488372093024,47.96511627906977
E00052629,332,173,159,52.108433734939766,47.89156626506024
E00052638,389,181,208,46.52956298200514,53.470437017994854
E00052622,366,182,184,49.72677595628415,50.27322404371585
E00052645,313,159,154,50.798722044728436,49.201277955271564
E00052646,261,144,117,55.172413793103445,44.827586206896555
E00052653,379,198,181,52.242744063324544,47.75725593667546
E00052727,360,184,176,51.11111111111111,48.888888888888886
E00052728,326,165,161,50.61349693251533,49.38650306748466
E00052737,376,193,183,51.329787234042556,48.67021276595745
E00052749,346,164,182,47.398843930635834,52.601156069364166
E00052757,248,130,118,52.41935483870967,47.58064516129033
E00052852,317,164,153,51.73501577287066,48.26498422712934
E00052853,405,200,205,49.382716049382715,50.617283950617285
E00052855,348,169,179,48.56321839080459,51.43678160919541
E00052857,279,130,149,46.59498207885305,53.40501792114696
E00052859,266,129,137,48.49624060150376,51.50375939849624
E00052845,337,175,162,51.92878338278932,48.07121661721068
E00052846,218,119,99,54.58715596330275,45.412844036697244
E00052850,375,194,181,51.733333333333334,48.266666666666666
E00052856,267,147,120,55.0561797752809,44.9438202247191
E00052870,327,164,163,50.15290519877675,49.84709480122324
E00052833,351,173,178,49.287749287749286,50.712250712250714
E00052849,266,139,127,52.255639097744364,47.744360902255636
E00052851,287,150,137,52.264808362369344,47.73519163763066
E00052854,262,141,121,53.81679389312977,46.18320610687023
E00052858,278,136,142,48.92086330935252,51.07913669064749
E00053082,407,210,197,51.5970515970516,48.402948402948404
E00053086,344,166,178,48.25581395348838,51.74418604651163
E00053107,333,170,163,51.051051051051054,48.94894894894895
E00053112,345,169,176,48.98550724637681,51.01449275362319
E00053080,189,95,94,50.264550264550266,49.735449735449734
E00053085,328,161,167,49.08536585365854,50.91463414634146
E00053088,459,232,227,50.54466230936819,49.45533769063181
E00053108,340,171,169,50.294117647058826,49.705882352941174
E00053110,315,152,163,48.25396825396825,51.746031746031754
E00052582,362,180,182,49.72375690607735,50.27624309392266
E00052583,293,125,168,42.66211604095563,57.33788395904437
E00052585,286,150,136,52.44755244755245,47.55244755244755
E00052608,482,255,227,52.9045643153527,47.0954356846473
E00052612,260,131,129,50.38461538461539,49.61538461538461
E00167332,353,165,188,46.742209631728045,53.25779036827195
E00167335,178,98,80,55.0561797752809,44.9438202247191
E00052602,374,202,172,54.01069518716578,45.98930481283423
E00052603,537,285,252,53.072625698324025,46.927374301675975
E00052604,541,301,240,55.637707948244,44.36229205175601
E00052605,367,194,173,52.86103542234333,47.13896457765668
E00052606,387,207,180,53.48837209302325,46.51162790697674
E00052607,355,171,184,48.16901408450705,51.83098591549295
E00052609,349,172,177,49.28366762177651,50.71633237822349
E00052611,319,155,164,48.589341692789965,51.410658307210035
E00052613,485,249,236,51.340206185567006,48.65979381443299
E00052631,521,267,254,51.24760076775432,48.75239923224568
E00052633,358,187,171,52.23463687150838,47.76536312849162
E00052634,290,152,138,52.41379310344828,47.58620689655172
E00052639,331,162,169,48.94259818731118,51.057401812688816
E00052641,367,171,196,46.59400544959128,53.40599455040872
E00052973,311,176,135,56.59163987138264,43.40836012861736
E00052976,366,190,176,51.91256830601093,48.08743169398907
E00052978,250,133,117,53.2,46.800000000000004
E00052980,313,170,143,54.31309904153354,45.68690095846645
E00052983,260,149,111,57.30769230769231,42.69230769230769
E00052952,303,159,144,52.475247524752476,47.524752475247524
E00052977,236,117,119,49.57627118644068,50.42372881355932
E00052979,183,62,121,33.87978142076503,66.12021857923497
E00052981,241,92,149,38.17427385892116,61.82572614107884
E00052982,290,140,150,48.275862068965516,51.724137931034484
E00052984,353,190,163,53.82436260623229,46.1756373937677
E00052985,314,154,160,49.044585987261144,50.955414012738856
E00052953,302,146,156,48.34437086092716,51.65562913907284
E00052954,356,190,166,53.37078651685393,46.62921348314607
E00052986,339,178,161,52.50737463126843,47.49262536873156
E00052987,318,151,167,47.48427672955975,52.51572327044025
E00052988,251,125,126,49.800796812749006,50.199203187250994
E00052955,299,143,156,47.82608695652174,52.17391304347826
E00052956,356,183,173,51.40449438202247,48.59550561797753
E00052957,292,151,141,51.71232876712328,48.28767123287671
E00052958,333,171,162,51.35135135135135,48.64864864864865
E00052949,338,175,163,51.77514792899408,48.22485207100592
E00052962,269,140,129,52.04460966542751,47.95539033457249
E00052965,356,181,175,50.84269662921348,49.157303370786515
E00052966,303,148,155,48.84488448844885,51.15511551155115
E00052969,311,157,154,50.482315112540185,49.51768488745981
E00052775,411,218,193,53.04136253041363,46.95863746958637
E00052777,443,223,220,50.338600451467265,49.66139954853273
E00052778,323,178,145,55.10835913312694,44.89164086687307
E00052782,388,196,192,50.51546391752577,49.48453608247423
E00167337,386,178,208,46.1139896373057,53.8860103626943
E00167339,231,121,110,52.38095238095239,47.61904761904761
E00167340,307,160,147,52.11726384364821,47.88273615635179
E00052776,343,183,160,53.352769679300295,46.647230320699705
E00052779,343,168,175,48.97959183673469,51.02040816326531
E00052781,207,102,105,49.275362318840585,50.72463768115942
E00052785,247,135,112,54.655870445344135,45.34412955465587
E00052786,282,143,139,50.70921985815603,49.29078014184397
E00181860,196,104,92,53.06122448979592,46.93877551020408
E00181865,125,61,64,48.8,51.2
E00181868,577,295,282,51.12651646447141,48.87348353552859
E00181878,353,182,171,51.55807365439094,48.44192634560906
E00052761,486,235,251,48.35390946502058,51.64609053497943
E00052784,311,163,148,52.41157556270096,47.58842443729904
E00052787,293,134,159,45.73378839590443,54.26621160409556
E00181882,234,119,115,50.85470085470085,49.14529914529914
E00181883,536,284,252,52.98507462686567,47.01492537313433
E00181905,174,80,94,45.97701149425287,54.02298850574713
E00052764,390,208,182,53.333333333333336,46.666666666666664
E00052768,355,199,156,56.056338028169016,43.94366197183099
E00052774,272,125,147,45.955882352941174,54.04411764705882
E00052780,344,193,151,56.104651162790695,43.895348837209305
E00052796,301,151,150,50.16611295681063,49.83388704318937
E00052763,215,115,100,53.48837209302325,46.51162790697674
E00052767,323,169,154,52.32198142414861,47.6780185758514
E00052771,572,271,301,47.37762237762238,52.62237762237763
E00052773,440,198,242,45,55.00000000000001
E00052795,383,190,193,49.60835509138381,50.391644908616186
E00181895,449,227,222,50.55679287305123,49.44320712694877
E00181925,264,123,141,46.590909090909086,53.40909090909091
E00052660,438,230,208,52.51141552511416,47.48858447488584
E00052676,513,263,250,51.267056530214425,48.732943469785575
E00052680,453,223,230,49.22737306843267,50.77262693156733
E00052682,424,202,222,47.64150943396226,52.358490566037744
E00052662,327,164,163,50.15290519877675,49.84709480122324
E00052681,370,195,175,52.702702702702695,47.2972972972973
E00052684,394,192,202,48.73096446700508,51.26903553299492
E00052686,461,235,226,50.97613882863341,49.0238611713666
E00052661,464,235,229,50.646551724137936,49.353448275862064
E00052663,354,174,180,49.152542372881356,50.847457627118644
E00052688,353,179,174,50.70821529745042,49.29178470254957
E00052689,358,176,182,49.162011173184354,50.83798882681564
E00053084,387,194,193,50.129198966408275,49.87080103359173
E00053109,410,220,190,53.65853658536586,46.34146341463415
E00053111,397,201,196,50.62972292191436,49.37027707808564
E00053114,356,188,168,52.80898876404494,47.19101123595505
E00053081,327,165,162,50.45871559633027,49.54128440366973
E00053090,394,197,197,50,50
E00053091,390,179,211,45.8974358974359,54.1025641025641
E00053096,308,149,159,48.37662337662338,51.62337662337663
E00053098,259,136,123,52.509652509652504,47.49034749034749
E00053087,241,131,110,54.356846473029044,45.643153526970956
E00053089,351,172,179,49.002849002849004,50.997150997150996
E00053094,319,185,134,57.993730407523515,42.00626959247649
E00053104,295,156,139,52.88135593220339,47.11864406779661
E00053105,345,168,177,48.69565217391305,51.30434782608696
E00053093,303,158,145,52.14521452145215,47.85478547854785
E00053095,367,178,189,48.501362397820166,51.49863760217984
E00053100,333,171,162,51.35135135135135,48.64864864864865
E00053103,359,182,177,50.69637883008357,49.30362116991643
E00053106,291,143,148,49.140893470790374,50.85910652920962
E00053078,360,176,184,48.888888888888886,51.11111111111111
E00053097,307,157,150,51.14006514657981,48.85993485342019
E00053099,352,171,181,48.57954545454545,51.42045454545454
E00053101,316,167,149,52.84810126582279,47.151898734177216
E00053102,327,164,163,50.15290519877675,49.84709480122324
E00053077,348,169,179,48.56321839080459,51.43678160919541
E00053079,396,208,188,52.52525252525253,47.474747474747474
E00053083,334,174,160,52.09580838323353,47.90419161676647
E00053092,339,178,161,52.50737463126843,47.49262536873156
E00053113,290,156,134,53.79310344827586,46.206896551724135
E00053164,341,166,175,48.68035190615836,51.31964809384164
E00053165,323,177,146,54.79876160990712,45.20123839009288
E00053166,181,92,89,50.82872928176796,49.171270718232044
E00053167,257,138,119,53.69649805447471,46.30350194552529
E00053168,346,180,166,52.02312138728323,47.97687861271676
E00053169,342,173,169,50.58479532163743,49.41520467836257
E00053160,335,180,155,53.73134328358209,46.26865671641791
E00053170,335,166,169,49.55223880597015,50.44776119402985
E00053171,269,145,124,53.90334572490706,46.09665427509294
E00053172,340,176,164,51.76470588235295,48.23529411764706
E00053179,300,162,138,54,46
E00053173,386,191,195,49.48186528497409,50.51813471502591
E00053174,353,168,185,47.59206798866856,52.40793201133145
E00053175,290,156,134,53.79310344827586,46.206896551724135
E00053177,308,159,149,51.62337662337663,48.37662337662338
E00053180,324,176,148,54.32098765432099,45.67901234567901
E00053184,303,160,143,52.8052805280528,47.194719471947195
E00053187,304,158,146,51.973684210526315,48.026315789473685
E00053189,318,161,157,50.62893081761006,49.37106918238994
E00053190,287,140,147,48.78048780487805,51.21951219512195
E00053192,248,115,133,46.37096774193548,53.62903225806451
E00052578,476,234,242,49.159663865546214,50.84033613445378
E00052579,287,162,125,56.44599303135889,43.55400696864111
E00052581,309,171,138,55.33980582524271,44.66019417475729
E00052588,259,135,124,52.123552123552116,47.87644787644788
E00052595,293,154,139,52.55972696245734,47.44027303754266
E00181853,447,242,205,54.138702460850105,45.86129753914989
E00181872,206,100,106,48.54368932038835,51.45631067961165
E00181920,155,73,82,47.096774193548384,52.903225806451616
E00052587,242,111,131,45.867768595041326,54.132231404958674
E00052590,266,142,124,53.383458646616546,46.616541353383454
E00052591,443,239,204,53.95033860045147,46.04966139954853
E00052601,367,183,184,49.863760217983646,50.13623978201635
E00181851,392,191,201,48.724489795918366,51.275510204081634
E00181880,289,145,144,50.17301038062284,49.82698961937716
E00181914,160,87,73,54.37499999999999,45.625
E00052580,326,173,153,53.06748466257669,46.93251533742331
E00052589,297,152,145,51.178451178451176,48.821548821548824
E00052592,314,164,150,52.22929936305732,47.77070063694268
E00052593,307,151,156,49.185667752442995,50.814332247557005
E00167320,203,92,111,45.320197044334975,54.679802955665025
E00167334,211,101,110,47.867298578199055,52.13270142180095
E00167343,196,99,97,50.51020408163265,49.48979591836735
E00167345,289,141,148,48.78892733564014,51.21107266435986
E00052594,379,199,180,52.5065963060686,47.4934036939314
E00052596,283,152,131,53.71024734982333,46.28975265017668
E00052597,380,195,185,51.31578947368421,48.68421052631579
E00052599,279,147,132,52.68817204301075,47.31182795698925
E00052600,381,192,189,50.39370078740157,49.60629921259843
E00053163,366,201,165,54.91803278688525,45.08196721311475
E00053185,322,184,138,57.14285714285714,42.857142857142854
E00053191,318,173,145,54.40251572327044,45.59748427672956
E00053194,265,139,126,52.45283018867924,47.54716981132076
E00053196,175,96,79,54.85714285714286,45.14285714285714
E00053197,341,165,176,48.38709677419355,51.61290322580645
E00053161,321,149,172,46.41744548286604,53.58255451713395
E00053162,316,157,159,49.68354430379747,50.31645569620253
E00053195,444,227,217,51.126126126126124,48.873873873873876
E00053198,331,166,165,50.15105740181269,49.848942598187314
E00053199,327,171,156,52.293577981651374,47.706422018348626
E00053159,411,201,210,48.9051094890511,51.09489051094891
E00053176,365,182,183,49.86301369863014,50.136986301369866
E00053178,416,215,201,51.682692307692314,48.31730769230769
E00053183,309,148,161,47.896440129449836,52.103559870550164
E00053181,348,163,185,46.839080459770116,53.16091954022989
E00053182,305,158,147,51.80327868852459,48.19672131147541
E00053186,307,150,157,48.85993485342019,51.14006514657981
E00053188,323,165,158,51.08359133126935,48.91640866873065
E00053193,276,160,116,57.971014492753625,42.028985507246375
E00052665,418,191,227,45.69377990430622,54.30622009569378
E00052669,300,177,123,59,41
E00052673,428,222,206,51.86915887850467,48.13084112149533
E00052679,373,198,175,53.08310991957105,46.91689008042895
E00052658,410,208,202,50.73170731707317,49.26829268292683
E00052670,435,205,230,47.12643678160919,52.87356321839081
E00052671,335,167,168,49.850746268656714,50.14925373134328
E00052678,432,210,222,48.61111111111111,51.388888888888886
E00052657,445,221,224,49.66292134831461,50.337078651685395
E00052659,454,213,241,46.91629955947136,53.08370044052864
E00052677,459,238,221,51.85185185185185,48.148148148148145
E00052674,359,184,175,51.25348189415042,48.74651810584958
E00052675,364,176,188,48.35164835164835,51.64835164835166
E00052683,322,153,169,47.51552795031056,52.484472049689444
E00052685,464,204,260,43.96551724137931,56.03448275862068
E00052687,332,167,165,50.30120481927711,49.6987951807229
E00052664,269,133,136,49.44237918215613,50.55762081784386
E00052668,483,239,244,49.4824016563147,50.5175983436853
E00167348,624,304,320,48.717948717948715,51.28205128205128
E00052790,276,135,141,48.91304347826087,51.08695652173913
E00052791,401,200,201,49.87531172069826,50.12468827930174
E00052792,355,182,173,51.267605633802816,48.732394366197184
E00052793,322,168,154,52.17391304347826,47.82608695652174
E00052794,353,172,181,48.725212464589234,51.27478753541076
E00053151,364,186,178,51.098901098901095,48.9010989010989
E00053152,600,310,290,51.66666666666667,48.333333333333336
E00053153,470,253,217,53.829787234042556,46.170212765957444
E00053154,505,259,246,51.28712871287129,48.71287128712871
E00052769,324,172,152,53.086419753086425,46.913580246913575
E00052772,362,221,141,61.04972375690608,38.950276243093924
E00181888,286,161,125,56.29370629370629,43.70629370629371
E00181889,168,93,75,55.35714285714286,44.642857142857146
E00181890,585,307,278,52.478632478632484,47.521367521367516
E00052770,524,269,255,51.335877862595424,48.66412213740458
E00181873,432,229,203,53.00925925925925,46.99074074074074
E00181921,334,161,173,48.20359281437126,51.796407185628745
