OA,ts0080001,ts0080002,ts0080003,ts0080002_PCT,ts0080003_PCT
E00038673,356,187,169,52.52808988764045,47.47191011235955
E00038692,193,88,105,45.59585492227979,54.40414507772021
E00038695,389,197,192,50.6426735218509,49.3573264781491
E00038696,312,168,144,53.84615384615385,46.15384615384615
E00038697,349,168,181,48.13753581661891,51.862464183381086
E00038693,390,196,194,50.256410256410255,49.743589743589745
E00038694,325,170,155,52.307692307692314,47.69230769230769
E00038700,350,174,176,49.714285714285715,50.28571428571429
E00038701,328,165,163,50.30487804878049,49.69512195121951
E00038674,338,169,169,50,50
E00038698,331,176,155,53.17220543806647,46.82779456193353
E00038699,329,170,159,51.671732522796354,48.328267477203646
E00038702,334,178,156,53.293413173652695,46.706586826347305
E00038703,432,222,210,51.388888888888886,48.61111111111111
E00038662,227,118,109,51.98237885462555,48.01762114537445
E00038663,216,108,108,50,50
E00038664,528,288,240,54.54545454545454,45.45454545454545
E00038665,378,191,187,50.52910052910053,49.47089947089947
E00182679,189,95,94,50.264550264550266,49.735449735449734
E00182701,413,215,198,52.05811138014528,47.94188861985472
E00037962,269,147,122,54.646840148698885,45.353159851301115
E00037965,236,119,117,50.42372881355932,49.57627118644068
E00037966,267,148,119,55.430711610486895,44.569288389513105
E00037967,250,137,113,54.800000000000004,45.2
E00037975,247,128,119,51.821862348178136,48.178137651821864
E00037976,294,155,139,52.721088435374156,47.27891156462585
E00037954,259,121,138,46.71814671814672,53.28185328185329
E00037957,279,141,138,50.53763440860215,49.46236559139785
E00037959,153,80,73,52.28758169934641,47.712418300653596
E00037960,221,107,114,48.41628959276018,51.58371040723983
E00037961,393,196,197,49.87277353689568,50.12722646310432
E00037977,145,77,68,53.103448275862064,46.89655172413793
E00037978,177,85,92,48.0225988700565,51.9774011299435
E00037943,295,159,136,53.898305084745765,46.101694915254235
E00037956,326,166,160,50.920245398773,49.079754601226995
E00037963,345,178,167,51.59420289855072,48.40579710144928
E00037971,240,133,107,55.41666666666667,44.583333333333336
E00182689,143,71,72,49.65034965034965,50.349650349650354
E00182704,358,194,164,54.18994413407822,45.81005586592179
E00182711,384,190,194,49.47916666666667,50.520833333333336
E00037944,471,247,224,52.4416135881104,47.5583864118896
E00037947,312,161,151,51.60256410256411,48.3974358974359
E00037958,305,141,164,46.22950819672131,53.77049180327869
E00037968,315,162,153,51.42857142857142,48.57142857142857
E00037969,302,151,151,50,50
E00037942,506,264,242,52.17391304347826,47.82608695652174
E00037946,316,161,155,50.9493670886076,49.050632911392405
E00037948,321,168,153,52.336448598130836,47.66355140186916
E00037951,256,129,127,50.390625,49.609375
E00037952,267,137,130,51.31086142322098,48.68913857677903
E00037941,275,134,141,48.72727272727273,51.272727272727266
E00037945,297,157,140,52.861952861952865,47.13804713804714
E00037949,522,267,255,51.14942528735632,48.85057471264368
E00037950,236,123,113,52.118644067796616,47.88135593220339
E00037955,271,156,115,57.564575645756456,42.435424354243544
E00037964,512,259,253,50.5859375,49.4140625
E00037970,353,187,166,52.97450424929179,47.02549575070821
E00037972,293,152,141,51.877133105802045,48.122866894197955
E00037973,290,152,138,52.41379310344828,47.58620689655172
E00037974,273,137,136,50.18315018315018,49.81684981684982
E00038704,306,149,157,48.69281045751634,51.307189542483655
E00038706,308,163,145,52.922077922077925,47.07792207792208
E00038708,343,185,158,53.93586005830904,46.06413994169096
E00038710,354,185,169,52.259887005649716,47.740112994350284
E00038713,272,150,122,55.14705882352941,44.85294117647059
E00038666,137,69,68,50.36496350364964,49.63503649635037
E00038707,395,216,179,54.68354430379747,45.31645569620253
E00038709,392,194,198,49.48979591836735,50.51020408163265
E00038711,281,150,131,53.380782918149464,46.619217081850536
E00038715,331,151,180,45.61933534743202,54.38066465256798
E00038668,301,161,140,53.48837209302325,46.51162790697674
E00038676,315,161,154,51.11111111111111,48.888888888888886
E00038678,286,146,140,51.048951048951054,48.95104895104895
E00038681,229,128,101,55.895196506550214,44.10480349344978
E00038682,399,203,196,50.877192982456144,49.122807017543856
E00038667,313,150,163,47.92332268370607,52.07667731629393
E00038675,337,158,179,46.88427299703264,53.11572700296736
E00038677,268,140,128,52.23880597014925,47.76119402985074
E00038679,401,207,194,51.6209476309227,48.37905236907731
E00038712,504,259,245,51.388888888888886,48.61111111111111
E00038714,333,173,160,51.95195195195195,48.048048048048045
E00038669,313,159,154,50.798722044728436,49.201277955271564
E00038680,402,191,211,47.51243781094527,52.48756218905473
E00038689,318,167,151,52.51572327044025,47.48427672955975
E00038690,242,124,118,51.2396694214876,48.760330578512395
E00038691,297,154,143,51.85185185185185,48.148148148148145
E00038670,348,175,173,50.287356321839084,49.712643678160916
E00038671,402,194,208,48.258706467661696,51.741293532338304
E00038672,340,168,172,49.411764705882355,50.588235294117645
E00038684,333,179,154,53.753753753753756,46.246246246246244
E00038683,293,150,143,51.19453924914675,48.80546075085324
E00038685,357,174,183,48.739495798319325,51.26050420168067
E00038686,324,173,151,53.39506172839506,46.60493827160494
E00038687,294,157,137,53.40136054421769,46.59863945578231
E00038688,321,163,158,50.77881619937694,49.22118380062305
E00038639,327,159,168,48.62385321100918,51.37614678899083
E00038640,307,148,159,48.20846905537459,51.79153094462541
E00038651,307,155,152,50.4885993485342,49.5114006514658
E00038661,462,228,234,49.35064935064935,50.649350649350644
E00038641,373,197,176,52.81501340482574,47.18498659517426
E00038642,367,181,186,49.31880108991826,50.68119891008175
E00038647,206,97,109,47.0873786407767,52.9126213592233
E00038650,328,154,174,46.95121951219512,53.04878048780488
E00038653,292,156,136,53.42465753424658,46.57534246575342
E00038644,320,159,161,49.6875,50.31250000000001
E00038652,280,155,125,55.35714285714286,44.642857142857146
E00038654,329,160,169,48.632218844984806,51.3677811550152
E00038656,410,213,197,51.951219512195124,48.048780487804876
E00038659,257,135,122,52.52918287937744,47.47081712062256
E00038655,348,178,170,51.14942528735632,48.85057471264368
E00038657,328,171,157,52.13414634146341,47.86585365853659
E00038658,298,157,141,52.68456375838926,47.31543624161073
E00038660,403,201,202,49.87593052109181,50.12406947890818
E00038643,355,175,180,49.29577464788733,50.70422535211267
E00038645,335,183,152,54.62686567164179,45.37313432835821
E00038646,315,161,154,51.11111111111111,48.888888888888886
E00038648,294,155,139,52.721088435374156,47.27891156462585
E00038649,235,127,108,54.04255319148936,45.95744680851064
E00037837,232,126,106,54.310344827586206,45.689655172413794
E00037851,241,129,112,53.52697095435685,46.47302904564315
E00037854,262,133,129,50.76335877862596,49.23664122137404
E00037855,213,107,106,50.23474178403756,49.76525821596244
E00037865,269,142,127,52.78810408921933,47.21189591078067
E00037830,308,150,158,48.701298701298704,51.298701298701296
E00037839,312,155,157,49.67948717948718,50.32051282051282
E00037850,301,156,145,51.82724252491694,48.17275747508305
E00037857,338,171,167,50.591715976331365,49.40828402366864
E00037838,285,139,146,48.771929824561404,51.2280701754386
E00037853,258,130,128,50.3875968992248,49.6124031007752
E00037856,241,117,124,48.54771784232365,51.45228215767634
E00037862,297,146,151,49.158249158249156,50.841750841750844
E00037864,278,134,144,48.201438848920866,51.798561151079134
E00037833,347,172,175,49.56772334293948,50.43227665706051
E00037852,270,134,136,49.629629629629626,50.37037037037037
E00037860,238,124,114,52.10084033613446,47.89915966386555
E00037861,236,123,113,52.118644067796616,47.88135593220339
E00037866,284,140,144,49.29577464788733,50.70422535211267
E00037829,303,156,147,51.48514851485149,48.51485148514851
E00037832,307,152,155,49.5114006514658,50.4885993485342
E00037858,247,135,112,54.655870445344135,45.34412955465587
E00037859,317,168,149,52.99684542586751,47.003154574132495
E00037870,251,129,122,51.39442231075697,48.60557768924303
E00037831,295,137,158,46.440677966101696,53.559322033898304
E00037863,215,127,88,59.06976744186046,40.93023255813954
E00037867,232,118,114,50.86206896551724,49.137931034482754
E00037868,202,106,96,52.475247524752476,47.524752475247524
E00037869,248,126,122,50.806451612903224,49.193548387096776
E00038278,304,152,152,50,50
E00038312,241,117,124,48.54771784232365,51.45228215767634
E00038316,339,155,184,45.72271386430678,54.27728613569322
E00038317,385,184,201,47.79220779220779,52.2077922077922
E00038318,264,137,127,51.89393939393939,48.10606060606061
E00038280,267,151,116,56.55430711610487,43.445692883895134
E00038284,270,135,135,50,50
E00038287,281,146,135,51.95729537366548,48.04270462633452
E00038293,194,105,89,54.123711340206185,45.876288659793815
E00038322,302,146,156,48.34437086092716,51.65562913907284
E00038288,305,158,147,51.80327868852459,48.19672131147541
E00038296,342,176,166,51.461988304093566,48.53801169590643
E00038311,323,179,144,55.417956656346746,44.58204334365325
E00038321,366,189,177,51.63934426229508,48.36065573770492
E00038276,330,167,163,50.60606060606061,49.3939393939394
E00038277,310,159,151,51.29032258064517,48.70967741935484
E00038306,235,112,123,47.65957446808511,52.34042553191489
E00038307,242,133,109,54.958677685950406,45.04132231404959
E00038308,226,122,104,53.98230088495575,46.017699115044245
E00038295,311,155,156,49.839228295819936,50.160771704180064
E00038298,221,109,112,49.321266968325794,50.678733031674206
E00038300,247,121,126,48.987854251012145,51.012145748987855
E00038301,255,131,124,51.37254901960784,48.627450980392155
E00038302,314,162,152,51.59235668789809,48.40764331210191
E00038313,394,205,189,52.03045685279187,47.96954314720812
E00038314,423,231,192,54.60992907801418,45.39007092198582
E00038315,289,150,139,51.903114186851205,48.09688581314879
E00038320,327,178,149,54.43425076452599,45.56574923547401
E00038611,467,231,236,49.46466809421842,50.53533190578159
E00038636,300,147,153,49,51
E00038637,294,155,139,52.721088435374156,47.27891156462585
E00038638,330,171,159,51.81818181818182,48.18181818181818
E00038618,295,153,142,51.864406779661024,48.13559322033898
E00038620,382,210,172,54.973821989528794,45.0261780104712
E00038621,227,117,110,51.541850220264315,48.458149779735685
E00038622,230,116,114,50.43478260869565,49.56521739130435
E00038625,279,149,130,53.40501792114696,46.59498207885305
E00038612,239,128,111,53.55648535564853,46.44351464435147
E00038613,201,111,90,55.223880597014926,44.776119402985074
E00038619,237,122,115,51.47679324894515,48.52320675105485
E00038623,244,130,114,53.278688524590166,46.72131147540984
E00038624,300,161,139,53.666666666666664,46.33333333333333
E00038614,255,131,124,51.37254901960784,48.627450980392155
E00038617,555,278,277,50.09009009009009,49.90990990990991
E00038627,265,141,124,53.20754716981132,46.79245283018868
E00038630,251,121,130,48.20717131474104,51.79282868525896
E00038632,595,307,288,51.59663865546219,48.403361344537814
E00038616,292,148,144,50.68493150684932,49.31506849315068
E00038626,259,144,115,55.5984555984556,44.4015444015444
E00038628,221,119,102,53.84615384615385,46.15384615384615
E00038629,236,127,109,53.813559322033896,46.186440677966104
E00038631,317,159,158,50.1577287066246,49.8422712933754
E00038615,284,147,137,51.76056338028169,48.23943661971831
E00038633,244,131,113,53.68852459016394,46.31147540983606
E00038634,259,136,123,52.509652509652504,47.49034749034749
E00038635,382,195,187,51.047120418848166,48.952879581151834
E00038286,290,153,137,52.758620689655174,47.241379310344826
E00038289,512,257,255,50.1953125,49.8046875
E00038294,299,151,148,50.50167224080268,49.49832775919732
E00038310,217,123,94,56.68202764976959,43.31797235023041
E00038319,285,135,150,47.368421052631575,52.63157894736842
E00038274,347,168,179,48.414985590778095,51.5850144092219
E00038309,381,190,191,49.86876640419948,50.13123359580053
E00172382,2092,129,1963,6.166347992351817,93.83365200764818
E00172401,114,57,57,50,50
E00038279,307,157,150,51.14006514657981,48.85993485342019
E00038281,342,194,148,56.72514619883041,43.27485380116959
E00038285,267,135,132,50.56179775280899,49.43820224719101
E00038291,276,139,137,50.36231884057971,49.63768115942029
E00038292,265,128,137,48.301886792452834,51.698113207547166
E00038282,357,181,176,50.700280112044815,49.299719887955185
E00038290,562,166,396,29.537366548042705,70.46263345195729
E00038297,271,135,136,49.815498154981555,50.184501845018445
E00038275,310,165,145,53.2258064516129,46.774193548387096
E00038283,490,267,223,54.48979591836734,45.51020408163266
E00038299,246,126,120,51.21951219512195,48.78048780487805
E00038303,340,177,163,52.05882352941177,47.94117647058824
E00038305,265,140,125,52.83018867924528,47.16981132075472
E00037843,339,187,152,55.16224188790561,44.83775811209439
E00037872,227,114,113,50.22026431718062,49.77973568281938
E00037876,258,126,132,48.837209302325576,51.162790697674424
E00037878,277,137,140,49.458483754512635,50.54151624548736
E00037881,363,189,174,52.066115702479344,47.93388429752066
E00037836,301,155,146,51.49501661129568,48.50498338870432
E00037871,591,291,300,49.23857868020304,50.76142131979695
E00037875,357,190,167,53.221288515406165,46.778711484593835
E00037879,286,143,143,50,50
E00037880,330,168,162,50.90909090909091,49.09090909090909
E00037844,328,170,158,51.829268292682926,48.170731707317074
E00037848,359,186,173,51.81058495821726,48.18941504178273
E00037877,321,163,158,50.77881619937694,49.22118380062305
E00037882,310,162,148,52.25806451612903,47.74193548387097
E00182667,328,180,148,54.87804878048781,45.1219512195122
E00182724,340,185,155,54.41176470588235,45.588235294117645
E00037841,340,169,171,49.705882352941174,50.294117647058826
E00037845,310,153,157,49.354838709677416,50.645161290322584
E00037846,338,170,168,50.29585798816568,49.70414201183432
E00037847,310,160,150,51.61290322580645,48.38709677419355
E00037849,209,104,105,49.760765550239235,50.23923444976076
E00037834,401,191,210,47.63092269326683,52.36907730673317
E00037835,263,143,120,54.372623574144484,45.627376425855516
E00037840,249,133,116,53.41365461847389,46.58634538152611
E00037873,162,79,83,48.76543209876543,51.23456790123457
E00037874,306,158,148,51.633986928104584,48.366013071895424
E00038035,154,76,78,49.35064935064935,50.649350649350644
E00038055,344,177,167,51.45348837209303,48.54651162790697
E00038057,312,161,151,51.60256410256411,48.3974358974359
E00038058,294,146,148,49.65986394557823,50.34013605442177
E00038060,283,146,137,51.590106007067135,48.409893992932865
E00038034,355,163,192,45.91549295774648,54.08450704225351
E00038039,290,144,146,49.6551724137931,50.3448275862069
E00038043,269,133,136,49.44237918215613,50.55762081784386
E00038059,362,193,169,53.31491712707182,46.68508287292818
E00038032,340,161,179,47.35294117647059,52.64705882352941
E00038036,243,116,127,47.73662551440329,52.2633744855967
E00038038,377,199,178,52.785145888594165,47.214854111405835
E00182692,114,68,46,59.64912280701754,40.35087719298245
E00182695,239,131,108,54.811715481171554,45.18828451882845
E00182705,468,236,232,50.427350427350426,49.572649572649574
E00038030,373,200,173,53.61930294906166,46.38069705093834
E00038045,334,159,175,47.604790419161674,52.39520958083832
E00038047,293,156,137,53.242320819112635,46.75767918088737
E00038049,287,140,147,48.78048780487805,51.21951219512195
E00038051,251,111,140,44.223107569721115,55.77689243027888
E00038033,297,153,144,51.515151515151516,48.484848484848484
E00038040,335,186,149,55.52238805970149,44.47761194029851
E00038042,251,131,120,52.191235059760956,47.808764940239044
E00038046,259,144,115,55.5984555984556,44.4015444015444
E00038050,219,121,98,55.25114155251142,44.74885844748858
E00038062,287,156,131,54.35540069686411,45.64459930313589
E00038031,368,189,179,51.358695652173914,48.641304347826086
E00038048,234,109,125,46.58119658119658,53.41880341880342
E00038052,373,193,180,51.742627345844504,48.257372654155496
E00038053,311,149,162,47.90996784565916,52.09003215434084
E00038054,218,103,115,47.24770642201835,52.752293577981646
E00038025,479,243,236,50.73068893528184,49.26931106471816
E00038026,414,221,193,53.3816425120773,46.61835748792271
E00038056,319,173,146,54.2319749216301,45.76802507836991
E00038061,315,170,145,53.96825396825397,46.03174603174603
E00037928,306,150,156,49.01960784313725,50.98039215686274
E00037929,400,209,191,52.25,47.75
E00037931,203,107,96,52.70935960591133,47.29064039408867
E00037932,239,116,123,48.53556485355649,51.46443514644351
E00037938,281,138,143,49.11032028469751,50.88967971530249
E00037927,269,138,131,51.301115241635685,48.698884758364315
E00037930,464,242,222,52.1551724137931,47.8448275862069
E00037933,314,162,152,51.59235668789809,48.40764331210191
E00037936,386,194,192,50.259067357512954,49.740932642487046
E00037937,373,182,191,48.793565683646115,51.206434316353885
E00037925,262,128,134,48.854961832061065,51.14503816793893
E00037926,283,139,144,49.11660777385159,50.8833922261484
E00037934,320,167,153,52.1875,47.8125
E00037935,285,155,130,54.385964912280706,45.614035087719294
E00037940,240,124,116,51.66666666666667,48.333333333333336
E00037884,405,207,198,51.11111111111111,48.888888888888886
E00037902,327,161,166,49.235474006116206,50.764525993883794
E00037903,330,170,160,51.515151515151516,48.484848484848484
E00037923,220,104,116,47.27272727272727,52.72727272727272
E00037939,348,171,177,49.137931034482754,50.86206896551724
E00038067,249,127,122,51.00401606425703,48.99598393574297
E00038077,300,151,149,50.33333333333333,49.666666666666664
E00038081,264,139,125,52.65151515151515,47.34848484848485
E00038087,309,155,154,50.161812297734635,49.83818770226537
E00182685,377,195,182,51.724137931034484,48.275862068965516
E00182708,325,159,166,48.92307692307693,51.07692307692307
E00182734,273,149,124,54.57875457875458,45.42124542124542
E00038063,341,189,152,55.42521994134897,44.57478005865102
E00038066,254,124,130,48.818897637795274,51.181102362204726
E00038073,283,154,129,54.416961130742045,45.583038869257955
E00038078,224,131,93,58.48214285714286,41.517857142857146
E00038085,355,181,174,50.985915492957744,49.014084507042256
E00038070,302,153,149,50.66225165562914,49.337748344370866
E00038072,267,143,124,53.558052434456926,46.441947565543074
E00038074,316,179,137,56.64556962025317,43.35443037974683
E00038075,276,135,141,48.91304347826087,51.08695652173913
E00038076,295,155,140,52.54237288135594,47.45762711864407
E00038065,334,176,158,52.69461077844312,47.30538922155689
E00038068,329,185,144,56.23100303951368,43.76899696048632
E00038097,268,131,137,48.88059701492538,51.11940298507462
E00038098,163,78,85,47.85276073619632,52.14723926380368
E00038100,352,188,164,53.40909090909091,46.590909090909086
E00038069,321,176,145,54.82866043613706,45.17133956386293
E00038071,306,163,143,53.26797385620915,46.73202614379085
E00038099,361,185,176,51.24653739612188,48.75346260387812
E00038101,304,154,150,50.6578947368421,49.34210526315789
E00038028,186,90,96,48.38709677419355,51.61290322580645
E00038029,367,182,185,49.59128065395095,50.40871934604905
E00038037,384,193,191,50.260416666666664,49.73958333333333
E00038041,316,164,152,51.89873417721519,48.10126582278481
E00038044,326,164,162,50.306748466257666,49.693251533742334
E00038080,299,132,167,44.14715719063545,55.852842809364546
E00038082,319,141,178,44.20062695924764,55.79937304075236
E00038083,292,151,141,51.71232876712328,48.28767123287671
E00038084,275,130,145,47.27272727272727,52.72727272727272
E00038086,312,165,147,52.88461538461539,47.11538461538461
E00038088,460,230,230,50,50
E00038089,262,137,125,52.29007633587786,47.70992366412214
E00038091,386,188,198,48.704663212435236,51.29533678756477
E00038092,287,151,136,52.613240418118465,47.386759581881535
E00038064,154,66,88,42.857142857142854,57.14285714285714
E00038090,240,119,121,49.583333333333336,50.416666666666664
E00038093,306,163,143,53.26797385620915,46.73202614379085
E00038094,257,133,124,51.75097276264592,48.249027237354085
E00038095,222,93,129,41.891891891891895,58.108108108108105
E00038096,253,125,128,49.40711462450593,50.59288537549407
E00037895,290,142,148,48.96551724137931,51.03448275862069
E00037896,270,133,137,49.25925925925926,50.74074074074074
E00037897,345,183,162,53.04347826086957,46.95652173913044
E00037898,339,170,169,50.14749262536873,49.852507374631266
E00037924,271,144,127,53.13653136531366,46.86346863468634
E00037893,411,212,199,51.58150851581509,48.41849148418492
E00037894,398,191,207,47.98994974874372,52.01005025125628
E00037899,284,149,135,52.46478873239436,47.53521126760563
E00037904,402,220,182,54.72636815920397,45.27363184079602
E00037885,267,154,113,57.67790262172284,42.32209737827715
E00037900,231,124,107,53.67965367965368,46.320346320346324
E00037905,233,127,106,54.506437768240346,45.493562231759654
E00037908,295,149,146,50.50847457627119,49.49152542372882
E00037913,323,165,158,51.08359133126935,48.91640866873065
E00172378,250,130,120,52,48
E00172379,368,179,189,48.641304347826086,51.358695652173914
E00172383,216,112,104,51.85185185185185,48.148148148148145
E00172384,342,169,173,49.41520467836257,50.58479532163743
E00172396,206,109,97,52.9126213592233,47.0873786407767
E00172398,261,141,120,54.02298850574713,45.97701149425287
E00037883,416,205,211,49.27884615384615,50.72115384615385
E00037901,372,179,193,48.11827956989247,51.88172043010753
E00172380,223,107,116,47.98206278026906,52.01793721973094
E00172381,329,161,168,48.93617021276596,51.06382978723404
E00172397,313,156,157,49.84025559105431,50.159744408945684
E00038325,303,158,145,52.14521452145215,47.85478547854785
E00038326,260,132,128,50.76923076923077,49.23076923076923
E00038355,319,156,163,48.90282131661442,51.09717868338558
E00038356,257,130,127,50.583657587548636,49.416342412451364
E00038357,294,163,131,55.44217687074829,44.5578231292517
E00038751,320,169,151,52.81249999999999,47.1875
E00038758,285,115,170,40.35087719298245,59.64912280701754
E00038764,291,142,149,48.797250859106526,51.20274914089347
E00038765,253,131,122,51.77865612648221,48.22134387351779
E00038767,273,137,136,50.18315018315018,49.81684981684982
E00038770,236,136,100,57.6271186440678,42.3728813559322
E00038769,463,237,226,51.18790496760259,48.81209503239741
E00038772,361,193,168,53.46260387811634,46.53739612188366
E00038774,356,194,162,54.49438202247191,45.50561797752809
E00038775,328,163,165,49.69512195121951,50.30487804878049
E00038778,334,180,154,53.89221556886228,46.10778443113773
E00038761,474,240,234,50.63291139240506,49.36708860759494
E00038762,371,188,183,50.673854447439346,49.32614555256065
E00038766,384,212,172,55.208333333333336,44.79166666666667
E00038768,360,186,174,51.66666666666667,48.333333333333336
E00038771,117,41,76,35.04273504273504,64.95726495726495
E00038773,366,202,164,55.19125683060109,44.80874316939891
E00038776,354,182,172,51.41242937853108,48.58757062146893
E00038777,320,163,157,50.9375,49.0625
E00038779,324,152,172,46.913580246913575,53.086419753086425
E00038781,267,135,132,50.56179775280899,49.43820224719101
E00038782,307,148,159,48.20846905537459,51.79153094462541
E00038756,335,162,173,48.35820895522388,51.64179104477612
E00038757,345,169,176,48.98550724637681,51.01449275362319
E00038759,333,168,165,50.45045045045045,49.549549549549546
E00038760,351,175,176,49.85754985754986,50.142450142450144
E00038763,271,143,128,52.767527675276746,47.23247232472325
E00038444,221,120,101,54.29864253393665,45.70135746606335
E00038449,330,165,165,50,50
E00038450,268,133,135,49.62686567164179,50.373134328358205
E00038452,252,136,116,53.96825396825397,46.03174603174603
E00038454,299,163,136,54.515050167224075,45.48494983277592
E00038442,329,175,154,53.191489361702125,46.808510638297875
E00038443,281,144,137,51.245551601423486,48.754448398576514
E00038445,219,106,113,48.401826484018265,51.598173515981735
E00038446,255,132,123,51.76470588235295,48.23529411764706
E00038451,296,151,145,51.01351351351351,48.986486486486484
E00038419,369,191,178,51.76151761517615,48.23848238482385
E00038420,403,208,195,51.61290322580645,48.38709677419355
E00038421,332,169,163,50.903614457831324,49.096385542168676
E00038422,255,139,116,54.509803921568626,45.490196078431374
E00038424,268,140,128,52.23880597014925,47.76119402985074
E00038423,337,178,159,52.818991097922854,47.18100890207715
E00038436,266,135,131,50.75187969924813,49.24812030075188
E00038437,256,129,127,50.390625,49.609375
E00038447,317,168,149,52.99684542586751,47.003154574132495
E00038448,238,128,110,53.78151260504202,46.21848739495798
E00038453,211,113,98,53.55450236966824,46.44549763033176
E00037887,227,109,118,48.01762114537445,51.98237885462555
E00037888,251,138,113,54.980079681274894,45.0199203187251
E00037910,321,169,152,52.64797507788161,47.35202492211838
E00037915,264,132,132,50,50
E00037920,242,124,118,51.2396694214876,48.760330578512395
E00037906,191,101,90,52.879581151832454,47.12041884816754
E00037909,315,168,147,53.333333333333336,46.666666666666664
E00037914,223,112,111,50.224215246636774,49.775784753363226
E00037917,315,164,151,52.06349206349207,47.93650793650794
E00037919,266,132,134,49.62406015037594,50.37593984962406
E00037886,267,141,126,52.80898876404494,47.19101123595505
E00037889,229,120,109,52.40174672489083,47.59825327510917
E00037891,423,213,210,50.35460992907801,49.645390070921984
E00037892,264,127,137,48.10606060606061,51.89393939393939
E00037921,205,102,103,49.75609756097561,50.24390243902439
E00037890,219,118,101,53.88127853881278,46.118721461187214
E00037912,353,175,178,49.57507082152974,50.42492917847026
E00037916,243,120,123,49.382716049382715,50.617283950617285
E00037918,224,125,99,55.80357142857143,44.19642857142857
E00037922,184,102,82,55.434782608695656,44.565217391304344
E00038323,279,160,119,57.34767025089605,42.65232974910394
E00038328,257,134,123,52.14007782101168,47.85992217898833
E00038340,355,181,174,50.985915492957744,49.014084507042256
E00038341,300,143,157,47.66666666666667,52.33333333333333
E00038347,359,182,177,50.69637883008357,49.30362116991643
E00038330,285,136,149,47.719298245614034,52.28070175438596
E00038331,368,188,180,51.08695652173913,48.91304347826087
E00038335,293,145,148,49.48805460750853,50.51194539249146
E00038336,253,141,112,55.73122529644269,44.26877470355731
E00038337,310,159,151,51.29032258064517,48.70967741935484
E00038327,255,123,132,48.23529411764706,51.76470588235295
E00038329,322,170,152,52.79503105590062,47.20496894409938
E00038332,307,167,140,54.39739413680782,45.60260586319218
E00038333,275,146,129,53.090909090909086,46.909090909090914
E00038334,251,146,105,58.16733067729084,41.832669322709165
E00038338,213,81,132,38.028169014084504,61.97183098591549
E00038339,271,138,133,50.92250922509225,49.07749077490775
E00038344,384,191,193,49.73958333333333,50.260416666666664
E00038349,346,182,164,52.601156069364166,47.398843930635834
E00038350,316,166,150,52.53164556962025,47.46835443037975
E00038324,352,185,167,52.55681818181818,47.44318181818182
E00038342,312,156,156,50,50
E00038346,339,170,169,50.14749262536873,49.852507374631266
E00038352,299,158,141,52.84280936454849,47.15719063545151
E00038353,238,129,109,54.20168067226891,45.79831932773109
E00038343,273,137,136,50.18315018315018,49.81684981684982
E00038345,337,173,164,51.33531157270029,48.6646884272997
E00038348,324,172,152,53.086419753086425,46.913580246913575
E00038351,336,174,162,51.78571428571429,48.214285714285715
E00038354,337,177,160,52.52225519287834,47.47774480712167
E00038717,352,181,171,51.42045454545454,48.57954545454545
E00038724,297,145,152,48.821548821548824,51.178451178451176
E00038739,380,184,196,48.421052631578945,51.578947368421055
E00182707,601,298,303,49.58402662229617,50.41597337770383
E00182738,137,57,80,41.605839416058394,58.3941605839416
E00038741,396,183,213,46.21212121212121,53.78787878787878
E00038742,281,143,138,50.88967971530249,49.11032028469751
E00038744,321,159,162,49.532710280373834,50.467289719626166
E00038746,294,145,149,49.31972789115646,50.68027210884354
E00038748,296,134,162,45.27027027027027,54.729729729729726
E00038723,351,164,187,46.72364672364672,53.27635327635327
E00038725,324,152,172,46.913580246913575,53.086419753086425
E00038727,294,155,139,52.721088435374156,47.27891156462585
E00038728,300,168,132,56.00000000000001,44
E00038730,266,144,122,54.13533834586466,45.86466165413533
E00038716,294,149,145,50.68027210884354,49.31972789115646
E00038718,315,148,167,46.98412698412698,53.01587301587302
E00038721,287,135,152,47.038327526132406,52.961672473867594
E00038722,260,139,121,53.46153846153846,46.53846153846154
E00038749,317,169,148,53.31230283911672,46.68769716088328
E00038780,325,143,182,44,56.00000000000001
E00038783,310,151,159,48.70967741935484,51.29032258064517
E00038784,264,114,150,43.18181818181818,56.81818181818182
E00038785,302,143,159,47.35099337748344,52.64900662251656
E00038786,327,172,155,52.59938837920489,47.40061162079511
E00038743,225,109,116,48.44444444444444,51.55555555555556
E00038745,392,143,249,36.47959183673469,63.52040816326531
E00182706,236,54,182,22.88135593220339,77.11864406779661
E00182731,244,81,163,33.19672131147541,66.80327868852459
E00038719,350,135,215,38.57142857142858,61.42857142857143
E00038720,333,132,201,39.63963963963964,60.36036036036037
E00038747,366,125,241,34.15300546448087,65.84699453551912
E00038411,367,185,182,50.40871934604905,49.59128065395095
E00038413,273,143,130,52.38095238095239,47.61904761904761
E00038429,245,132,113,53.87755102040816,46.12244897959184
E00038431,169,84,85,49.70414201183432,50.29585798816568
E00182647,301,150,151,49.83388704318937,50.16611295681063
E00038410,300,158,142,52.666666666666664,47.333333333333336
E00038412,286,148,138,51.74825174825175,48.25174825174825
E00038414,339,180,159,53.09734513274337,46.902654867256636
E00038415,285,141,144,49.473684210526315,50.526315789473685
E00038428,220,107,113,48.63636363636364,51.36363636363637
E00038416,248,129,119,52.016129032258064,47.983870967741936
E00038417,275,160,115,58.18181818181818,41.81818181818181
E00038418,326,192,134,58.895705521472394,41.104294478527606
E00038425,194,95,99,48.96907216494845,51.03092783505154
E00038426,198,97,101,48.98989898989899,51.010101010101
E00038427,177,91,86,51.41242937853108,48.58757062146893
E00038430,187,98,89,52.406417112299465,47.593582887700535
E00038559,248,133,115,53.62903225806451,46.37096774193548
E00038560,250,131,119,52.400000000000006,47.599999999999994
E00038561,240,124,116,51.66666666666667,48.333333333333336
E00038562,245,128,117,52.244897959183675,47.755102040816325
E00038563,262,129,133,49.23664122137404,50.76335877862596
E00038568,181,96,85,53.03867403314917,46.96132596685083
E00038569,176,91,85,51.70454545454546,48.29545454545455
E00038432,480,212,268,44.166666666666664,55.833333333333336
E00038433,263,129,134,49.049429657794676,50.950570342205324
E00038434,295,166,129,56.271186440677965,43.728813559322035
E00038440,317,161,156,50.78864353312302,49.21135646687697
E00038456,180,96,84,53.333333333333336,46.666666666666664
E00038435,276,142,134,51.449275362318836,48.55072463768116
E00038438,310,160,150,51.61290322580645,48.38709677419355
E00038439,393,230,163,58.524173027989825,41.475826972010175
E00038441,297,163,134,54.882154882154886,45.11784511784512
E00038455,256,136,120,53.125,46.875
E00038572,291,149,142,51.20274914089347,48.797250859106526
E00038577,316,158,158,50,50
E00038578,297,149,148,50.16835016835017,49.831649831649834
E00038580,259,134,125,51.737451737451735,48.26254826254826
E00038581,295,141,154,47.79661016949153,52.20338983050847
E00038574,196,109,87,55.61224489795919,44.38775510204081
E00038575,319,153,166,47.96238244514107,52.03761755485894
E00038576,368,190,178,51.63043478260869,48.369565217391305
E00038585,306,162,144,52.94117647058824,47.05882352941176
E00038573,294,152,142,51.70068027210885,48.29931972789115
E00038579,353,171,182,48.44192634560906,51.55807365439094
E00038582,411,209,202,50.85158150851582,49.148418491484186
E00038583,379,183,196,48.284960422163586,51.71503957783641
E00038584,397,199,198,50.12594458438288,49.87405541561713
E00038151,327,165,162,50.45871559633027,49.54128440366973
E00038161,1056,126,930,11.931818181818182,88.06818181818183
E00038164,355,180,175,50.70422535211267,49.29577464788733
E00038169,287,164,123,57.14285714285714,42.857142857142854
E00038174,284,144,140,50.70422535211267,49.29577464788733
E00038168,339,154,185,45.42772861356932,54.572271386430685
E00038173,428,205,223,47.89719626168225,52.10280373831776
E00038175,291,139,152,47.766323024054984,52.23367697594502
E00172394,490,241,249,49.183673469387756,50.816326530612244
E00038152,382,200,182,52.35602094240838,47.64397905759162
E00038166,280,129,151,46.07142857142857,53.92857142857142
E00038177,175,80,95,45.714285714285715,54.285714285714285
E00038180,266,126,140,47.368421052631575,52.63157894736842
E00038181,222,114,108,51.35135135135135,48.64864864864865
E00038182,277,135,142,48.73646209386281,51.26353790613718
E00038734,371,178,193,47.97843665768194,52.02156334231805
E00038736,382,219,163,57.32984293193717,42.67015706806283
E00038737,313,170,143,54.31309904153354,45.68690095846645
E00038738,309,149,160,48.22006472491909,51.7799352750809
E00038740,260,137,123,52.69230769230769,47.30769230769231
E00038752,336,166,170,49.404761904761905,50.595238095238095
E00038753,343,156,187,45.481049562682216,54.518950437317784
E00038755,246,89,157,36.17886178861789,63.82113821138211
E00038787,304,158,146,51.973684210526315,48.026315789473685
E00038788,332,157,175,47.28915662650602,52.71084337349398
E00182715,219,95,124,43.37899543378995,56.62100456621004
E00182726,248,103,145,41.53225806451613,58.46774193548387
E00182653,299,123,176,41.1371237458194,58.862876254180605
E00182666,316,151,165,47.78481012658228,52.21518987341772
E00182713,133,46,87,34.58646616541353,65.41353383458647
E00182737,235,112,123,47.65957446808511,52.34042553191489
E00182740,206,93,113,45.14563106796117,54.85436893203883
E00038731,365,186,179,50.95890410958904,49.04109589041096
E00038732,307,137,170,44.62540716612378,55.37459283387622
E00038733,397,189,208,47.607052896725435,52.39294710327456
E00038735,415,192,223,46.265060240963855,53.73493975903615
E00038015,362,168,194,46.408839779005525,53.591160220994475
E00038016,242,117,125,48.34710743801653,51.652892561983464
E00038017,401,208,193,51.87032418952619,48.12967581047381
E00038018,235,120,115,51.06382978723404,48.93617021276596
E00038020,267,129,138,48.31460674157304,51.68539325842697
E00038162,250,99,151,39.6,60.4
E00038163,206,82,124,39.80582524271845,60.19417475728155
E00038165,314,152,162,48.40764331210191,51.59235668789809
E00038167,325,173,152,53.230769230769226,46.76923076923077
E00038171,213,89,124,41.78403755868544,58.21596244131455
E00038172,299,135,164,45.1505016722408,54.84949832775919
E00038179,197,82,115,41.62436548223351,58.37563451776649
E00038148,367,169,198,46.049046321525886,53.950953678474114
E00038170,224,109,115,48.660714285714285,51.33928571428571
E00038183,327,170,157,51.98776758409785,48.01223241590214
E00038184,347,188,159,54.17867435158501,45.821325648414984
E00038185,255,126,129,49.411764705882355,50.588235294117645
E00038149,303,132,171,43.56435643564357,56.43564356435643
E00038150,341,170,171,49.853372434017594,50.146627565982406
E00038153,224,103,121,45.982142857142854,54.01785714285714
E00038156,321,159,162,49.532710280373834,50.467289719626166
E00038159,279,123,156,44.086021505376344,55.91397849462365
E00038103,223,112,111,50.224215246636774,49.775784753363226
E00038114,260,132,128,50.76923076923077,49.23076923076923
E00038116,278,147,131,52.87769784172662,47.122302158273385
E00038121,305,173,132,56.72131147540984,43.278688524590166
E00038123,279,141,138,50.53763440860215,49.46236559139785
E00038128,178,84,94,47.19101123595505,52.80898876404494
E00038102,224,125,99,55.80357142857143,44.19642857142857
E00038105,347,186,161,53.602305475504316,46.39769452449568
E00038142,358,190,168,53.072625698324025,46.927374301675975
E00038144,330,181,149,54.848484848484844,45.151515151515156
E00038145,271,138,133,50.92250922509225,49.07749077490775
E00038107,307,158,149,51.465798045602604,48.534201954397396
E00038109,326,178,148,54.601226993865026,45.39877300613497
E00038112,284,150,134,52.816901408450704,47.183098591549296
E00038113,312,162,150,51.92307692307693,48.07692307692308
E00038118,210,111,99,52.85714285714286,47.14285714285714
E00038500,243,123,120,50.617283950617285,49.382716049382715
E00038501,266,132,134,49.62406015037594,50.37593984962406
E00038502,269,137,132,50.92936802973978,49.07063197026022
E00038515,285,149,136,52.28070175438596,47.719298245614034
E00038516,266,133,133,50,50
E00038115,353,188,165,53.25779036827195,46.742209631728045
E00038126,306,145,161,47.385620915032675,52.614379084967325
E00038127,297,155,142,52.18855218855219,47.81144781144781
E00038132,232,122,110,52.58620689655172,47.41379310344828
E00038134,271,141,130,52.02952029520295,47.97047970479705
E00038136,261,127,134,48.65900383141762,51.34099616858238
E00038138,246,133,113,54.0650406504065,45.9349593495935
E00038139,353,179,174,50.70821529745042,49.29178470254957
E00038140,307,149,158,48.534201954397396,51.465798045602604
E00038141,313,155,158,49.52076677316294,50.47923322683706
E00038117,303,156,147,51.48514851485149,48.51485148514851
E00038124,332,163,169,49.096385542168676,50.903614457831324
E00038129,344,167,177,48.54651162790697,51.45348837209303
E00038130,340,169,171,49.705882352941174,50.294117647058826
E00038131,278,148,130,53.23741007194245,46.76258992805755
E00038108,305,149,156,48.85245901639344,51.147540983606554
E00038143,278,143,135,51.438848920863315,48.561151079136685
E00038146,260,138,122,53.07692307692308,46.92307692307692
E00038147,389,199,190,51.156812339331616,48.84318766066838
E00182652,195,93,102,47.69230769230769,52.307692307692314
E00182664,464,235,229,50.646551724137936,49.353448275862064
E00182739,133,66,67,49.62406015037594,50.37593984962406
E00038503,307,163,144,53.09446254071661,46.90553745928339
E00038504,370,204,166,55.13513513513514,44.86486486486487
E00038505,536,268,268,50,50
E00038509,314,157,157,50,50
E00038522,616,332,284,53.896103896103895,46.103896103896105
E00038541,276,145,131,52.53623188405797,47.46376811594203
E00038543,319,160,159,50.15673981191222,49.843260188087775
E00038544,257,139,118,54.08560311284047,45.91439688715953
E00038556,306,148,158,48.366013071895424,51.633986928104584
E00038518,324,162,162,50,50
E00038520,269,141,128,52.41635687732342,47.58364312267658
E00038524,250,122,128,48.8,51.2
E00038525,255,138,117,54.11764705882353,45.88235294117647
E00038526,238,119,119,50,50
E00038547,263,145,118,55.13307984790875,44.866920152091254
E00038548,291,145,146,49.828178694158076,50.171821305841924
E00038551,465,234,231,50.32258064516129,49.67741935483871
E00038552,229,109,120,47.59825327510917,52.40174672489083
E00038553,287,147,140,51.21951219512195,48.78048780487805
E00038542,440,221,219,50.227272727272734,49.77272727272727
E00038554,270,141,129,52.22222222222223,47.77777777777778
E00038555,447,228,219,51.006711409395976,48.99328859060403
E00038557,463,249,214,53.77969762419006,46.220302375809936
E00038558,369,192,177,52.03252032520326,47.96747967479675
E00038514,279,152,127,54.48028673835126,45.51971326164875
E00038517,279,144,135,51.61290322580645,48.38709677419355
E00038545,439,216,223,49.202733485193626,50.79726651480638
E00038546,313,156,157,49.84025559105431,50.159744408945684
E00038550,257,140,117,54.474708171206224,45.525291828793776
E00038104,260,136,124,52.307692307692314,47.69230769230769
E00038125,268,135,133,50.373134328358205,49.62686567164179
E00038133,255,140,115,54.90196078431373,45.09803921568628
E00038135,285,145,140,50.877192982456144,49.122807017543856
E00038137,239,128,111,53.55648535564853,46.44351464435147
E00038499,280,148,132,52.85714285714286,47.14285714285714
E00038506,227,112,115,49.33920704845815,50.66079295154186
E00038507,253,133,120,52.569169960474305,47.43083003952569
E00038508,331,167,164,50.453172205438065,49.546827794561935
E00038510,387,200,187,51.67958656330749,48.320413436692505
E00038511,285,144,141,50.526315789473685,49.473684210526315
E00038512,300,164,136,54.666666666666664,45.33333333333333
E00038513,349,177,172,50.71633237822349,49.28366762177651
E00182659,313,153,160,48.881789137380196,51.118210862619804
E00182674,375,188,187,50.13333333333333,49.86666666666667
E00182681,446,232,214,52.01793721973094,47.98206278026906
E00182683,141,69,72,48.93617021276596,51.06382978723404
E00172373,236,116,120,49.152542372881356,50.847457627118644
E00172374,167,78,89,46.706586826347305,53.293413173652695
E00172375,333,168,165,50.45045045045045,49.549549549549546
E00182661,231,108,123,46.75324675324675,53.246753246753244
E00182675,306,149,157,48.69281045751634,51.307189542483655
E00182700,186,94,92,50.53763440860215,49.46236559139785
E00038120,325,175,150,53.84615384615385,46.15384615384615
E00038122,311,165,146,53.054662379421224,46.94533762057878
E00172372,349,180,169,51.57593123209169,48.42406876790831
E00172376,269,141,128,52.41635687732342,47.58364312267658
E00172377,115,54,61,46.95652173913044,53.04347826086957
E00037979,333,155,178,46.546546546546544,53.453453453453456
E00037990,375,198,177,52.800000000000004,47.199999999999996
E00037993,301,130,171,43.18936877076412,56.810631229235874
E00037997,304,148,156,48.68421052631579,51.31578947368421
E00038019,418,205,213,49.04306220095694,50.95693779904307
E00037982,339,170,169,50.14749262536873,49.852507374631266
E00037995,337,185,152,54.89614243323442,45.103857566765576
E00037999,240,122,118,50.83333333333333,49.166666666666664
E00038004,345,168,177,48.69565217391305,51.30434782608696
E00038154,267,133,134,49.812734082397,50.187265917603
E00038155,372,164,208,44.086021505376344,55.91397849462365
E00038157,291,143,148,49.140893470790374,50.85910652920962
E00038158,367,165,202,44.95912806539509,55.04087193460491
E00038160,413,195,218,47.21549636803874,52.78450363196126
E00038186,254,131,123,51.574803149606296,48.4251968503937
E00172385,206,98,108,47.57281553398058,52.42718446601942
E00172386,393,216,177,54.961832061068705,45.038167938931295
E00182651,549,284,265,51.73041894353369,48.26958105646631
E00182693,396,202,194,51.010101010101,48.98989898989899
E00182732,203,109,94,53.69458128078818,46.30541871921182
E00037984,321,162,159,50.467289719626166,49.532710280373834
E00037988,339,178,161,52.50737463126843,47.49262536873156
E00038013,385,202,183,52.467532467532465,47.53246753246753
E00172388,293,137,156,46.75767918088737,53.242320819112635
E00172389,263,133,130,50.57034220532319,49.42965779467681
E00172395,310,159,151,51.29032258064517,48.70967741935484
E00037989,406,189,217,46.55172413793103,53.44827586206896
E00038021,400,217,183,54.25,45.75
E00038022,399,196,203,49.122807017543856,50.877192982456144
E00038024,398,207,191,52.01005025125628,47.98994974874372
E00037980,317,178,139,56.15141955835961,43.84858044164038
E00037981,350,171,179,48.857142857142854,51.142857142857146
E00037994,337,197,140,58.45697329376854,41.54302670623146
E00038023,324,153,171,47.22222222222222,52.77777777777778
E00037983,273,137,136,50.18315018315018,49.81684981684982
E00037992,422,186,236,44.07582938388626,55.92417061611374
E00037998,329,169,160,51.3677811550152,48.632218844984806
E00038001,246,119,127,48.3739837398374,51.6260162601626
E00038006,270,146,124,54.074074074074076,45.925925925925924
E00037985,281,142,139,50.5338078291815,49.46619217081851
E00037986,185,90,95,48.64864864864865,51.35135135135135
E00037991,330,179,151,54.24242424242425,45.75757575757576
E00038000,381,198,183,51.96850393700787,48.031496062992126
E00038007,223,130,93,58.29596412556054,41.70403587443946
E00037996,246,125,121,50.81300813008131,49.1869918699187
E00038002,271,136,135,50.184501845018445,49.815498154981555
E00038003,326,167,159,51.22699386503068,48.77300613496933
E00038008,220,109,111,49.54545454545455,50.45454545454545
E00038010,233,123,110,52.78969957081545,47.21030042918455
E00037987,445,224,221,50.337078651685395,49.66292134831461
E00038009,241,123,118,51.037344398340245,48.96265560165975
E00038011,356,174,182,48.87640449438202,51.12359550561798
E00038012,227,109,118,48.01762114537445,51.98237885462555
E00038014,253,124,129,49.01185770750988,50.988142292490124
E00038375,210,113,97,53.80952380952381,46.19047619047619
E00038378,168,86,82,51.19047619047619,48.80952380952381
E00038379,407,206,201,50.61425061425061,49.385749385749385
E00038387,116,64,52,55.172413793103445,44.827586206896555
E00038389,367,210,157,57.22070844686649,42.77929155313351
E00038368,337,159,178,47.18100890207715,52.818991097922854
E00038369,258,128,130,49.6124031007752,50.3875968992248
E00038393,358,194,164,54.18994413407822,45.81005586592179
E00038399,300,151,149,50.33333333333333,49.666666666666664
E00038405,282,137,145,48.58156028368794,51.41843971631206
E00038365,297,145,152,48.821548821548824,51.178451178451176
E00038366,247,138,109,55.87044534412956,44.12955465587044
E00038367,278,141,137,50.719424460431654,49.280575539568346
E00182658,158,73,85,46.20253164556962,53.79746835443038
E00182660,196,96,100,48.97959183673469,51.02040816326531
E00182688,228,113,115,49.56140350877193,50.43859649122807
E00182698,559,280,279,50.089445438282645,49.910554561717355
E00182717,379,204,175,53.825857519788926,46.17414248021108
E00182721,188,90,98,47.87234042553192,52.12765957446809
E00182733,268,135,133,50.373134328358205,49.62686567164179
E00038358,243,115,128,47.325102880658434,52.674897119341566
E00038359,299,152,147,50.836120401337794,49.163879598662206
E00038370,240,116,124,48.333333333333336,51.66666666666667
E00038374,273,141,132,51.64835164835166,48.35164835164835
E00038385,214,99,115,46.26168224299065,53.73831775700935
E00038383,245,123,122,50.204081632653065,49.795918367346935
E00038390,254,131,123,51.574803149606296,48.4251968503937
E00038402,383,205,178,53.52480417754569,46.47519582245431
E00038403,267,138,129,51.68539325842697,48.31460674157304
E00038406,505,263,242,52.07920792079208,47.92079207920792
E00038371,283,146,137,51.590106007067135,48.409893992932865
E00038372,223,109,114,48.87892376681614,51.12107623318386
E00038373,285,140,145,49.122807017543856,50.877192982456144
E00038377,234,115,119,49.14529914529914,50.85470085470085
E00038381,299,157,142,52.508361204013376,47.491638795986624
E00038360,226,107,119,47.34513274336283,52.654867256637175
E00038376,304,166,138,54.60526315789473,45.39473684210527
E00038380,286,150,136,52.44755244755245,47.55244755244755
E00038382,260,124,136,47.69230769230769,52.307692307692314
E00038386,374,196,178,52.406417112299465,47.593582887700535
E00038362,369,200,169,54.20054200542005,45.799457994579946
E00038384,320,168,152,52.5,47.5
E00038394,267,131,136,49.063670411985015,50.936329588014985
E00038404,208,97,111,46.63461538461539,53.36538461538461
E00038407,284,145,139,51.056338028169016,48.943661971830984
E00038388,350,180,170,51.42857142857142,48.57142857142857
E00038395,253,120,133,47.43083003952569,52.569169960474305
E00038396,263,127,136,48.28897338403042,51.71102661596958
E00038400,339,174,165,51.32743362831859,48.67256637168141
E00038401,208,107,101,51.442307692307686,48.55769230769231
E00038361,267,129,138,48.31460674157304,51.68539325842697
E00038363,348,171,177,49.137931034482754,50.86206896551724
E00038364,277,131,146,47.292418772563174,52.707581227436826
E00038392,207,104,103,50.24154589371981,49.75845410628019
E00038397,296,162,134,54.729729729729726,45.27027027027027
E00038198,299,163,136,54.515050167224075,45.48494983277592
E00038209,316,158,158,50,50
E00038215,293,150,143,51.19453924914675,48.80546075085324
E00038219,329,163,166,49.544072948328264,50.455927051671736
E00172392,199,106,93,53.266331658291456,46.733668341708544
E00172393,147,76,71,51.70068027210885,48.29931972789115
E00172399,263,132,131,50.19011406844106,49.80988593155893
E00038187,439,221,218,50.34168564920274,49.65831435079727
E00038194,278,140,138,50.35971223021583,49.64028776978417
E00038204,301,149,152,49.501661129568106,50.498338870431894
E00038210,222,110,112,49.549549549549546,50.45045045045045
E00038232,275,137,138,49.81818181818182,50.18181818181818
E00182719,279,152,127,54.48028673835126,45.51971326164875
E00182720,271,133,138,49.07749077490775,50.92250922509225
E00038188,240,128,112,53.333333333333336,46.666666666666664
E00038199,264,134,130,50.75757575757576,49.24242424242424
E00038206,248,114,134,45.96774193548387,54.03225806451613
E00038230,357,171,186,47.89915966386555,52.10084033613446
E00038233,315,162,153,51.42857142857142,48.57142857142857
E00038196,341,181,160,53.0791788856305,46.9208211143695
E00038197,288,146,142,50.69444444444444,49.30555555555556
E00038200,271,137,134,50.55350553505535,49.44649446494465
E00038203,234,119,115,50.85470085470085,49.14529914529914
E00038229,256,145,111,56.640625,43.359375
E00038231,268,140,128,52.23880597014925,47.76119402985074
E00038239,332,162,170,48.795180722891565,51.204819277108435
E00038242,241,117,124,48.54771784232365,51.45228215767634
E00038261,275,137,138,49.81818181818182,50.18181818181818
E00038265,267,126,141,47.19101123595505,52.80898876404494
E00038268,224,118,106,52.67857142857143,47.32142857142857
E00038263,254,132,122,51.96850393700787,48.031496062992126
E00038264,293,146,147,49.829351535836174,50.170648464163826
E00038269,377,188,189,49.86737400530504,50.132625994694955
E00038270,316,166,150,52.53164556962025,47.46835443037975
E00038272,382,194,188,50.78534031413613,49.21465968586388
E00038262,218,128,90,58.71559633027523,41.284403669724774
E00038266,244,138,106,56.557377049180324,43.44262295081967
E00038267,227,117,110,51.541850220264315,48.458149779735685
E00038271,359,179,180,49.86072423398329,50.13927576601671
E00038273,284,142,142,50,50
E00038564,288,141,147,48.95833333333333,51.041666666666664
E00038565,250,124,126,49.6,50.4
E00038566,295,144,151,48.8135593220339,51.186440677966104
E00038567,263,137,126,52.09125475285171,47.90874524714829
E00038570,227,114,113,50.22026431718062,49.77973568281938
E00038586,302,141,161,46.688741721854306,53.31125827814569
E00038236,325,160,165,49.23076923076923,50.76923076923077
E00038238,220,108,112,49.09090909090909,50.90909090909091
E00038240,273,128,145,46.88644688644688,53.11355311355312
E00038241,280,132,148,47.14285714285714,52.85714285714286
E00038254,258,125,133,48.44961240310077,51.55038759689923
E00038243,297,146,151,49.158249158249156,50.841750841750844
E00038244,297,133,164,44.78114478114478,55.218855218855225
E00038245,303,146,157,48.18481848184818,51.81518151815182
E00038246,310,140,170,45.16129032258064,54.83870967741935
E00038251,265,130,135,49.056603773584904,50.943396226415096
E00038248,293,159,134,54.26621160409556,45.73378839590443
E00038249,296,166,130,56.08108108108109,43.91891891891892
E00038253,340,177,163,52.05882352941177,47.94117647058824
E00182699,529,272,257,51.417769376181475,48.582230623818525
E00182718,302,158,144,52.317880794701985,47.682119205298015
E00182735,100,48,52,48,52
E00038234,277,141,136,50.90252707581227,49.09747292418773
E00038235,317,160,157,50.473186119873816,49.52681388012618
E00038247,229,122,107,53.275109170305676,46.724890829694324
E00038250,312,151,161,48.3974358974359,51.60256410256411
E00038257,288,150,138,52.083333333333336,47.91666666666667
E00038255,372,188,184,50.53763440860215,49.46236559139785
E00038256,290,142,148,48.96551724137931,51.03448275862069
E00038258,316,174,142,55.06329113924051,44.936708860759495
E00038259,375,190,185,50.66666666666667,49.333333333333336
E00038260,325,175,150,53.84615384615385,46.15384615384615
E00038189,240,122,118,50.83333333333333,49.166666666666664
E00038190,220,113,107,51.36363636363637,48.63636363636364
E00038213,293,156,137,53.242320819112635,46.75767918088737
E00038217,251,105,146,41.832669322709165,58.16733067729084
E00038218,265,137,128,51.698113207547166,48.301886792452834
E00038220,334,164,170,49.101796407185624,50.898203592814376
E00038207,311,162,149,52.09003215434084,47.90996784565916
E00038208,307,162,145,52.76872964169381,47.23127035830619
E00038212,307,158,149,51.465798045602604,48.534201954397396
E00038216,301,159,142,52.823920265780735,47.176079734219265
E00038221,296,158,138,53.37837837837838,46.62162162162162
E00038191,387,196,191,50.64599483204134,49.35400516795866
E00038202,344,182,162,52.90697674418605,47.093023255813954
E00038205,324,175,149,54.01234567901234,45.98765432098765
E00038211,379,223,156,58.839050131926115,41.16094986807388
E00038192,282,135,147,47.87234042553192,52.12765957446809
E00038214,306,155,151,50.65359477124183,49.34640522875817
E00038224,358,188,170,52.513966480446925,47.486033519553075
E00038226,335,176,159,52.537313432835816,47.462686567164184
E00038227,338,180,158,53.25443786982249,46.74556213017752
E00038193,405,203,202,50.123456790123456,49.876543209876544
E00038222,245,130,115,53.06122448979592,46.93877551020408
E00038223,323,164,159,50.77399380804953,49.22600619195047
E00038225,253,136,117,53.75494071146245,46.24505928853755
E00038228,270,139,131,51.48148148148148,48.51851851851852
E00038484,247,119,128,48.178137651821864,51.821862348178136
E00038486,284,152,132,53.52112676056338,46.478873239436616
E00038493,255,127,128,49.80392156862745,50.19607843137255
E00038495,311,155,156,49.839228295819936,50.160771704180064
E00038496,308,161,147,52.27272727272727,47.72727272727273
E00038461,405,222,183,54.81481481481482,45.18518518518518
E00038464,304,158,146,51.973684210526315,48.026315789473685
E00038479,208,119,89,57.21153846153846,42.78846153846153
E00038485,374,181,193,48.39572192513369,51.60427807486631
E00172390,359,178,181,49.58217270194986,50.41782729805014
E00172391,308,160,148,51.94805194805194,48.05194805194805
E00038458,332,173,159,52.108433734939766,47.89156626506024
E00038466,285,145,140,50.877192982456144,49.122807017543856
E00038474,268,138,130,51.49253731343284,48.507462686567166
E00038477,299,145,154,48.49498327759198,51.50501672240802
E00038468,296,164,132,55.4054054054054,44.5945945945946
E00038469,367,179,188,48.77384196185286,51.22615803814714
E00038475,294,157,137,53.40136054421769,46.59863945578231
E00038476,262,124,138,47.32824427480916,52.67175572519084
E00038481,249,124,125,49.79919678714859,50.20080321285141
E00038482,307,160,147,52.11726384364821,47.88273615635179
E00038487,307,146,161,47.55700325732899,52.44299674267101
E00038491,289,148,141,51.21107266435986,48.78892733564014
E00038492,318,151,167,47.48427672955975,52.51572327044025
E00038460,314,147,167,46.81528662420382,53.18471337579618
E00038470,391,197,194,50.38363171355499,49.61636828644501
E00038473,405,206,199,50.864197530864196,49.135802469135804
E00038480,396,199,197,50.252525252525245,49.74747474747475
E00038483,214,117,97,54.67289719626168,45.32710280373832
E00038467,323,178,145,55.10835913312694,44.89164086687307
E00038471,308,163,145,52.922077922077925,47.07792207792208
E00038472,351,179,172,50.997150997150996,49.002849002849004
E00182684,109,54,55,49.54128440366973,50.45871559633027
E00182729,534,279,255,52.24719101123596,47.752808988764045
E00182736,331,165,166,49.848942598187314,50.15105740181269
E00038459,306,157,149,51.307189542483655,48.69281045751634
E00038478,280,141,139,50.357142857142854,49.642857142857146
E00038489,328,167,161,50.91463414634146,49.08536585365854
E00038494,276,150,126,54.347826086956516,45.65217391304348
E00038498,263,141,122,53.61216730038023,46.38783269961977
E00038462,239,112,127,46.86192468619247,53.13807531380753
E00038463,272,139,133,51.10294117647059,48.89705882352941
E00038465,456,250,206,54.824561403508774,45.17543859649123
E00038490,267,140,127,52.43445692883895,47.565543071161045
E00038497,321,173,148,53.89408099688473,46.10591900311526
E00038531,241,128,113,53.11203319502075,46.88796680497925
E00038534,337,176,161,52.22551928783383,47.774480712166174
E00038535,233,120,113,51.50214592274678,48.497854077253216
E00038536,557,299,258,53.680430879712745,46.319569120287255
E00038539,285,151,134,52.98245614035088,47.01754385964912
E00182648,551,292,259,52.994555353901994,47.005444646098006
E00038530,260,151,109,58.07692307692308,41.92307692307693
E00038532,306,151,155,49.34640522875817,50.65359477124183
E00038533,296,160,136,54.054054054054056,45.94594594594595
E00038537,317,158,159,49.8422712933754,50.1577287066246
E00038538,255,141,114,55.294117647058826,44.70588235294118
E00038540,323,165,158,51.08359133126935,48.91640866873065
E00038521,576,291,285,50.520833333333336,49.47916666666667
E00038527,397,195,202,49.1183879093199,50.88161209068011
E00182668,137,76,61,55.47445255474452,44.52554744525548
E00182672,118,58,60,49.152542372881356,50.847457627118644
E00182676,554,280,274,50.54151624548736,49.458483754512635
E00182677,569,285,284,50.08787346221442,49.91212653778559
E00182696,313,170,143,54.31309904153354,45.68690095846645
E00182743,346,177,169,51.15606936416185,48.84393063583815
E00038571,127,68,59,53.54330708661418,46.45669291338583
E00038607,256,124,132,48.4375,51.5625
E00038608,291,154,137,52.92096219931272,47.07903780068728
E00038609,296,151,145,51.01351351351351,48.986486486486484
E00038610,313,164,149,52.39616613418531,47.6038338658147
E00038591,260,131,129,50.38461538461539,49.61538461538461
E00038593,289,156,133,53.979238754325266,46.02076124567474
E00038599,266,141,125,53.00751879699248,46.99248120300752
E00038605,258,135,123,52.32558139534884,47.674418604651166
E00038606,273,134,139,49.08424908424908,50.91575091575091
E00038587,295,150,145,50.847457627118644,49.152542372881356
E00038592,306,156,150,50.98039215686274,49.01960784313725
E00038594,284,149,135,52.46478873239436,47.53521126760563
E00038595,250,117,133,46.800000000000004,53.2
E00038597,252,125,127,49.60317460317461,50.39682539682539
E00038588,267,141,126,52.80898876404494,47.19101123595505
E00038598,272,147,125,54.04411764705882,45.955882352941174
E00038602,197,100,97,50.76142131979695,49.23857868020304
E00038603,292,148,144,50.68493150684932,49.31506849315068
E00038604,239,127,112,53.13807531380753,46.86192468619247
E00038589,203,126,77,62.06896551724138,37.93103448275862
E00038590,246,135,111,54.87804878048781,45.1219512195122
E00038596,226,122,104,53.98230088495575,46.017699115044245
E00038600,213,123,90,57.74647887323944,42.25352112676056
E00038601,277,147,130,53.068592057761734,46.931407942238266
