OA,ts0540001,ts0540002,ts0540003,ts0540004,ts0540005,ts0540006,ts0540007,ts0540008,ts0540009,ts0540010,ts0540011,ts0540012,ts0540013,ts0540002_PCT,ts0540003_PCT,ts0540004_PCT,ts0540005_PCT,ts0540006_PCT,ts0540007_PCT,ts0540008_PCT,ts0540009_PCT,ts0540010_PCT,ts0540011_PCT,ts0540012_PCT,ts0540013_PCT
W00007742,137,67,34,33,0,0,64,14,50,6,4,2,0,48.9051094890511,24.817518248175183,24.087591240875913,0,0,46.715328467153284,10.218978102189782,36.496350364963504,4.37956204379562,2.9197080291970803,1.4598540145985401,0
W00007743,140,91,42,49,0,0,30,11,19,19,14,5,0,65,30,35,0,0,21.428571428571427,7.857142857142857,13.571428571428571,13.571428571428571,10,3.571428571428571,0
W00007744,151,101,58,43,0,0,28,13,15,22,15,7,0,66.88741721854305,38.41059602649007,28.47682119205298,0,0,18.543046357615893,8.609271523178808,9.933774834437086,14.56953642384106,9.933774834437086,4.635761589403973,0
W00007745,138,58,28,30,0,0,67,22,45,13,10,3,0,42.028985507246375,20.28985507246377,21.73913043478261,0,0,48.55072463768116,15.942028985507244,32.608695652173914,9.420289855072465,7.246376811594203,2.1739130434782608,0
W00007746,133,123,73,50,0,0,2,0,2,8,5,3,0,92.4812030075188,54.88721804511278,37.59398496240601,0,0,1.5037593984962405,0,1.5037593984962405,6.015037593984962,3.7593984962406015,2.2556390977443606,0
W00007747,130,99,49,50,0,0,15,4,11,16,10,6,0,76.15384615384615,37.69230769230769,38.46153846153847,0,0,11.538461538461538,3.076923076923077,8.461538461538462,12.307692307692308,7.6923076923076925,4.615384615384616,0
W00007748,136,102,56,46,0,0,23,9,14,11,9,2,0,75,41.17647058823529,33.82352941176471,0,0,16.911764705882355,6.61764705882353,10.294117647058822,8.088235294117647,6.61764705882353,1.4705882352941175,0
W00007749,153,51,31,20,1,1,99,29,70,2,1,1,0,33.33333333333333,20.26143790849673,13.071895424836603,0.6535947712418301,0.6535947712418301,64.70588235294117,18.954248366013072,45.751633986928105,1.3071895424836601,0.6535947712418301,0.6535947712418301,0
W00007750,120,57,27,30,0,0,52,15,37,11,10,1,0,47.5,22.5,25,0,0,43.333333333333336,12.5,30.833333333333336,9.166666666666666,8.333333333333332,0.8333333333333334,0
W00007751,164,130,63,67,1,1,22,3,19,11,9,2,0,79.26829268292683,38.41463414634146,40.853658536585364,0.6097560975609756,0.6097560975609756,13.414634146341465,1.8292682926829267,11.585365853658537,6.707317073170732,5.487804878048781,1.2195121951219512,0
W00007752,115,95,55,40,0,0,14,10,4,6,5,1,0,82.6086956521739,47.82608695652174,34.78260869565217,0,0,12.173913043478262,8.695652173913043,3.4782608695652173,5.217391304347826,4.3478260869565215,0.8695652173913043,0
W00007753,118,99,47,52,0,0,2,0,2,17,14,3,0,83.89830508474576,39.83050847457627,44.06779661016949,0,0,1.694915254237288,0,1.694915254237288,14.40677966101695,11.864406779661017,2.5423728813559325,0
W00007754,113,60,29,31,0,0,27,14,13,26,25,1,0,53.09734513274337,25.663716814159294,27.43362831858407,0,0,23.893805309734514,12.389380530973451,11.504424778761061,23.008849557522122,22.123893805309734,0.8849557522123894,0
W00007755,137,94,49,45,1,1,25,3,22,17,15,2,0,68.61313868613139,35.76642335766424,32.846715328467155,0.7299270072992701,0.7299270072992701,18.248175182481752,2.18978102189781,16.05839416058394,12.408759124087592,10.948905109489052,1.4598540145985401,0
W00007756,111,91,59,32,1,1,3,0,3,16,15,1,0,81.98198198198197,53.153153153153156,28.82882882882883,0.9009009009009009,0.9009009009009009,2.7027027027027026,0,2.7027027027027026,14.414414414414415,13.513513513513514,0.9009009009009009,0
W00007757,143,55,29,26,0,0,76,37,39,9,7,2,3,38.46153846153847,20.27972027972028,18.181818181818183,0,0,53.14685314685315,25.874125874125873,27.27272727272727,6.293706293706294,4.895104895104895,1.3986013986013985,2.097902097902098
W00007758,140,92,47,45,0,0,40,19,21,8,8,0,0,65.71428571428571,33.57142857142857,32.142857142857146,0,0,28.57142857142857,13.571428571428571,15,5.714285714285714,5.714285714285714,0,0
W00007759,120,60,36,24,0,0,57,21,36,3,2,1,0,50,30,20,0,0,47.5,17.5,30,2.5,1.6666666666666667,0.8333333333333334,0
W00007760,138,58,32,26,0,0,68,26,42,12,9,3,0,42.028985507246375,23.18840579710145,18.84057971014493,0,0,49.275362318840585,18.84057971014493,30.434782608695656,8.695652173913043,6.521739130434782,2.1739130434782608,0
W00007761,158,51,22,29,0,0,96,40,56,11,9,2,0,32.278481012658226,13.924050632911392,18.354430379746837,0,0,60.75949367088608,25.31645569620253,35.44303797468354,6.962025316455696,5.69620253164557,1.2658227848101267,0
W00007762,146,96,61,35,0,0,34,8,26,16,12,4,0,65.75342465753424,41.78082191780822,23.972602739726025,0,0,23.28767123287671,5.47945205479452,17.80821917808219,10.95890410958904,8.21917808219178,2.73972602739726,0
W00007763,140,114,74,40,0,0,14,1,13,12,5,7,0,81.42857142857143,52.85714285714286,28.57142857142857,0,0,10,0.7142857142857143,9.285714285714286,8.571428571428571,3.571428571428571,5,0
W00007764,124,81,58,23,0,0,5,2,3,38,34,4,0,65.32258064516128,46.774193548387096,18.548387096774192,0,0,4.032258064516129,1.6129032258064515,2.4193548387096775,30.64516129032258,27.419354838709676,3.225806451612903,0
W00007765,116,30,20,10,0,0,75,24,51,11,11,0,0,25.862068965517242,17.24137931034483,8.620689655172415,0,0,64.65517241379311,20.689655172413794,43.96551724137931,9.482758620689655,9.482758620689655,0,0
W00007766,202,159,64,95,0,0,22,11,11,21,17,4,0,78.71287128712872,31.683168316831683,47.02970297029702,0,0,10.891089108910892,5.445544554455446,5.445544554455446,10.396039603960396,8.415841584158416,1.9801980198019802,0
W00007767,144,127,85,42,0,0,2,1,1,15,11,4,0,88.19444444444444,59.02777777777778,29.166666666666668,0,0,1.3888888888888888,0.6944444444444444,0.6944444444444444,10.416666666666668,7.638888888888889,2.7777777777777777,0
W00007768,136,72,43,29,0,0,25,7,18,39,31,8,0,52.94117647058824,31.61764705882353,21.323529411764707,0,0,18.38235294117647,5.147058823529411,13.23529411764706,28.676470588235293,22.794117647058822,5.88235294117647,0
W00007769,125,42,25,17,0,0,59,17,42,22,18,4,2,33.6,20,13.600000000000001,0,0,47.199999999999996,13.600000000000001,33.6,17.599999999999998,14.399999999999999,3.2,1.6
W00007770,141,102,59,43,1,1,27,12,15,11,9,2,0,72.3404255319149,41.843971631205676,30.49645390070922,0.7092198581560284,0.7092198581560284,19.148936170212767,8.51063829787234,10.638297872340425,7.801418439716312,6.382978723404255,1.4184397163120568,0
W00007771,113,97,52,45,0,0,6,4,2,10,8,2,0,85.84070796460178,46.017699115044245,39.823008849557525,0,0,5.3097345132743365,3.5398230088495577,1.7699115044247788,8.849557522123893,7.079646017699115,1.7699115044247788,0
W00007772,120,104,67,37,0,0,2,0,2,14,12,2,0,86.66666666666667,55.833333333333336,30.833333333333336,0,0,1.6666666666666667,0,1.6666666666666667,11.666666666666666,10,1.6666666666666667,0
W00007773,116,89,54,35,0,0,9,6,3,18,13,5,0,76.72413793103449,46.55172413793103,30.17241379310345,0,0,7.758620689655173,5.172413793103448,2.586206896551724,15.517241379310345,11.206896551724139,4.310344827586207,0
W00007774,118,43,29,14,0,0,64,3,61,11,9,2,0,36.440677966101696,24.576271186440678,11.864406779661017,0,0,54.23728813559322,2.5423728813559325,51.69491525423729,9.322033898305085,7.627118644067797,1.694915254237288,0
W00007775,110,53,29,24,0,0,33,9,24,24,23,1,0,48.18181818181818,26.36363636363636,21.818181818181817,0,0,30,8.181818181818182,21.818181818181817,21.818181818181817,20.909090909090907,0.9090909090909091,0
W00007776,49,33,23,10,0,0,11,2,9,5,5,0,0,67.3469387755102,46.93877551020408,20.408163265306122,0,0,22.448979591836736,4.081632653061225,18.367346938775512,10.204081632653061,10.204081632653061,0,0
W00007777,120,83,49,34,0,0,11,3,8,26,24,2,0,69.16666666666667,40.833333333333336,28.333333333333332,0,0,9.166666666666666,2.5,6.666666666666667,21.666666666666668,20,1.6666666666666667,0
W00007778,149,99,48,51,0,0,41,15,26,9,6,3,0,66.44295302013423,32.21476510067114,34.22818791946309,0,0,27.516778523489933,10.06711409395973,17.449664429530202,6.0402684563758395,4.026845637583892,2.013422818791946,0
W00007779,118,89,52,37,0,0,13,5,8,16,15,1,0,75.42372881355932,44.06779661016949,31.35593220338983,0,0,11.016949152542372,4.23728813559322,6.779661016949152,13.559322033898304,12.711864406779661,0.847457627118644,0
W00007780,133,25,12,13,1,1,98,42,56,8,6,2,1,18.796992481203006,9.022556390977442,9.774436090225564,0.7518796992481203,0.7518796992481203,73.68421052631578,31.57894736842105,42.10526315789473,6.015037593984962,4.511278195488721,1.5037593984962405,0.7518796992481203
W00007781,163,86,50,36,1,1,44,9,35,32,24,8,0,52.760736196319016,30.67484662576687,22.085889570552148,0.6134969325153374,0.6134969325153374,26.993865030674847,5.521472392638037,21.472392638036812,19.631901840490798,14.723926380368098,4.9079754601226995,0
W00007782,132,59,32,27,0,0,52,22,30,21,13,8,0,44.696969696969695,24.242424242424242,20.454545454545457,0,0,39.39393939393939,16.666666666666664,22.727272727272727,15.909090909090908,9.848484848484848,6.0606060606060606,0
W00007783,144,53,36,17,0,0,43,9,34,48,41,7,0,36.80555555555556,25,11.805555555555555,0,0,29.86111111111111,6.25,23.61111111111111,33.33333333333333,28.47222222222222,4.861111111111112,0
W00007784,117,43,27,16,2,2,64,28,36,8,3,5,0,36.75213675213676,23.076923076923077,13.675213675213676,1.7094017094017095,1.7094017094017095,54.700854700854705,23.931623931623932,30.76923076923077,6.837606837606838,2.564102564102564,4.273504273504273,0
W00007785,111,60,34,26,0,0,36,21,15,15,10,5,0,54.054054054054056,30.630630630630627,23.423423423423422,0,0,32.432432432432435,18.91891891891892,13.513513513513514,13.513513513513514,9.00900900900901,4.504504504504505,0
W00007786,116,57,33,24,1,1,38,13,25,19,17,2,1,49.137931034482754,28.448275862068968,20.689655172413794,0.8620689655172413,0.8620689655172413,32.758620689655174,11.206896551724139,21.551724137931032,16.379310344827587,14.655172413793101,1.7241379310344827,0.8620689655172413
W00007787,114,72,28,44,0,0,20,9,11,22,19,3,0,63.1578947368421,24.561403508771928,38.59649122807017,0,0,17.543859649122805,7.894736842105263,9.649122807017543,19.298245614035086,16.666666666666664,2.631578947368421,0
W00007788,91,64,30,34,0,0,21,11,10,6,5,1,0,70.32967032967034,32.967032967032964,37.362637362637365,0,0,23.076923076923077,12.087912087912088,10.989010989010989,6.593406593406594,5.4945054945054945,1.098901098901099,0
W00007789,120,74,47,27,1,1,31,18,13,13,6,7,1,61.66666666666667,39.166666666666664,22.5,0.8333333333333334,0.8333333333333334,25.833333333333336,15,10.833333333333334,10.833333333333334,5,5.833333333333333,0.8333333333333334
W00007790,124,70,37,33,0,0,41,14,27,13,12,1,0,56.451612903225815,29.838709677419356,26.61290322580645,0,0,33.064516129032256,11.29032258064516,21.774193548387096,10.483870967741936,9.67741935483871,0.8064516129032258,0
W00007791,124,87,44,43,0,0,11,4,7,26,25,1,0,70.16129032258065,35.483870967741936,34.67741935483871,0,0,8.870967741935484,3.225806451612903,5.64516129032258,20.967741935483872,20.161290322580644,0.8064516129032258,0
W00007792,178,116,42,74,0,0,50,16,34,12,10,2,0,65.1685393258427,23.595505617977526,41.57303370786517,0,0,28.08988764044944,8.98876404494382,19.101123595505616,6.741573033707865,5.617977528089887,1.1235955056179776,0
W00007793,188,113,44,69,3,3,63,29,34,9,6,3,0,60.1063829787234,23.404255319148938,36.702127659574465,1.5957446808510638,1.5957446808510638,33.51063829787234,15.425531914893616,18.085106382978726,4.787234042553192,3.1914893617021276,1.5957446808510638,0
W00007794,132,77,48,29,0,0,38,14,24,17,13,4,0,58.333333333333336,36.36363636363637,21.96969696969697,0,0,28.78787878787879,10.606060606060606,18.181818181818183,12.878787878787879,9.848484848484848,3.0303030303030303,0
W00007795,132,83,42,41,0,0,31,11,20,18,16,2,0,62.878787878787875,31.818181818181817,31.060606060606062,0,0,23.484848484848484,8.333333333333332,15.151515151515152,13.636363636363635,12.121212121212121,1.5151515151515151,0
W00007796,107,102,69,33,0,0,3,2,1,2,2,0,0,95.32710280373831,64.48598130841121,30.8411214953271,0,0,2.803738317757009,1.8691588785046727,0.9345794392523363,1.8691588785046727,1.8691588785046727,0,0
W00007797,124,122,69,53,0,0,1,0,1,1,1,0,0,98.38709677419355,55.64516129032258,42.74193548387097,0,0,0.8064516129032258,0,0.8064516129032258,0.8064516129032258,0.8064516129032258,0,0
W00007798,131,118,77,41,0,0,9,4,5,4,2,2,0,90.07633587786259,58.778625954198475,31.297709923664126,0,0,6.870229007633588,3.0534351145038165,3.816793893129771,3.0534351145038165,1.5267175572519083,1.5267175572519083,0
W00007799,168,154,102,52,0,0,6,3,3,8,6,2,0,91.66666666666666,60.71428571428571,30.952380952380953,0,0,3.571428571428571,1.7857142857142856,1.7857142857142856,4.761904761904762,3.571428571428571,1.1904761904761905,0
W00007800,125,97,54,43,0,0,13,6,7,15,13,2,0,77.60000000000001,43.2,34.4,0,0,10.4,4.8,5.6000000000000005,12,10.4,1.6,0
W00007801,108,72,35,37,0,0,15,7,8,21,18,3,0,66.66666666666666,32.407407407407405,34.25925925925926,0,0,13.88888888888889,6.481481481481481,7.4074074074074066,19.444444444444446,16.666666666666664,2.7777777777777777,0
W00007802,121,81,51,30,0,0,27,11,16,13,10,3,0,66.94214876033058,42.14876033057851,24.793388429752067,0,0,22.31404958677686,9.090909090909092,13.223140495867769,10.743801652892563,8.264462809917356,2.479338842975207,0
W00007803,155,80,42,38,0,0,43,10,33,32,27,5,0,51.61290322580645,27.09677419354839,24.516129032258064,0,0,27.741935483870968,6.451612903225806,21.29032258064516,20.64516129032258,17.419354838709676,3.225806451612903,0
W00007804,121,58,28,30,0,0,45,16,29,18,17,1,0,47.93388429752066,23.140495867768596,24.793388429752067,0,0,37.1900826446281,13.223140495867769,23.96694214876033,14.87603305785124,14.049586776859504,0.8264462809917356,0
W00007805,119,81,42,39,0,0,14,5,9,24,24,0,0,68.0672268907563,35.294117647058826,32.773109243697476,0,0,11.76470588235294,4.201680672268908,7.563025210084033,20.168067226890756,20.168067226890756,0,0
W00007806,124,113,75,38,0,0,0,0,0,11,11,0,0,91.12903225806451,60.483870967741936,30.64516129032258,0,0,0,0,0,8.870967741935484,8.870967741935484,0,0
W00007807,130,87,46,41,0,0,32,10,22,11,8,3,0,66.92307692307692,35.38461538461539,31.538461538461537,0,0,24.615384615384617,7.6923076923076925,16.923076923076923,8.461538461538462,6.153846153846154,2.307692307692308,0
W00007808,148,69,33,36,0,0,37,11,26,42,35,7,0,46.62162162162162,22.2972972972973,24.324324324324326,0,0,25,7.4324324324324325,17.56756756756757,28.37837837837838,23.64864864864865,4.72972972972973,0
W00007809,117,83,53,30,0,0,14,6,8,20,17,3,0,70.94017094017094,45.2991452991453,25.64102564102564,0,0,11.965811965811966,5.128205128205128,6.837606837606838,17.094017094017094,14.529914529914532,2.564102564102564,0
W00007810,110,69,38,31,0,0,25,10,15,16,12,4,0,62.727272727272734,34.54545454545455,28.18181818181818,0,0,22.727272727272727,9.090909090909092,13.636363636363635,14.545454545454545,10.909090909090908,3.6363636363636362,0
W00007811,143,98,57,41,0,0,23,4,19,22,14,8,0,68.53146853146853,39.86013986013986,28.671328671328673,0,0,16.083916083916083,2.797202797202797,13.286713286713287,15.384615384615385,9.79020979020979,5.594405594405594,0
W00007812,131,109,71,38,0,0,7,2,5,15,15,0,0,83.20610687022901,54.19847328244275,29.00763358778626,0,0,5.343511450381679,1.5267175572519083,3.816793893129771,11.450381679389313,11.450381679389313,0,0
W00007813,132,87,54,33,0,0,35,5,30,10,9,1,0,65.9090909090909,40.909090909090914,25,0,0,26.515151515151516,3.787878787878788,22.727272727272727,7.575757575757576,6.8181818181818175,0.7575757575757576,0
W00007814,170,127,80,47,0,0,34,4,30,9,8,1,0,74.70588235294117,47.05882352941176,27.647058823529413,0,0,20,2.3529411764705883,17.647058823529413,5.294117647058823,4.705882352941177,0.5882352941176471,0
W00007815,126,98,65,33,0,0,13,4,9,15,12,3,0,77.77777777777779,51.587301587301596,26.190476190476193,0,0,10.317460317460316,3.1746031746031744,7.142857142857142,11.904761904761903,9.523809523809524,2.380952380952381,0
W00007816,130,93,52,41,0,0,25,10,15,12,9,3,0,71.53846153846153,40,31.538461538461537,0,0,19.230769230769234,7.6923076923076925,11.538461538461538,9.230769230769232,6.923076923076923,2.307692307692308,0
W00007817,123,87,47,40,0,0,25,13,12,11,9,2,0,70.73170731707317,38.21138211382114,32.52032520325203,0,0,20.32520325203252,10.569105691056912,9.75609756097561,8.94308943089431,7.317073170731707,1.6260162601626018,0
W00007818,173,71,42,29,0,0,91,62,29,11,7,4,0,41.040462427745666,24.277456647398843,16.76300578034682,0,0,52.601156069364166,35.83815028901734,16.76300578034682,6.358381502890173,4.046242774566474,2.312138728323699,0
W00007819,56,40,26,14,0,0,7,1,6,9,4,5,0,71.42857142857143,46.42857142857143,25,0,0,12.5,1.7857142857142856,10.714285714285714,16.071428571428573,7.142857142857142,8.928571428571429,0
W00007820,153,119,65,54,0,0,22,5,17,12,11,1,0,77.77777777777779,42.48366013071895,35.294117647058826,0,0,14.37908496732026,3.2679738562091507,11.11111111111111,7.8431372549019605,7.18954248366013,0.6535947712418301,0
W00007821,146,54,33,21,1,1,77,34,43,14,9,5,0,36.986301369863014,22.602739726027394,14.383561643835616,0.684931506849315,0.684931506849315,52.73972602739726,23.28767123287671,29.45205479452055,9.58904109589041,6.164383561643835,3.4246575342465753,0
W00007822,107,71,43,28,0,0,25,11,14,10,9,1,1,66.35514018691589,40.18691588785047,26.168224299065418,0,0,23.364485981308412,10.2803738317757,13.084112149532709,9.345794392523365,8.411214953271028,0.9345794392523363,0.9345794392523363
W00007823,132,101,47,54,10,10,2,1,1,19,17,2,0,76.51515151515152,35.60606060606061,40.909090909090914,7.575757575757576,7.575757575757576,1.5151515151515151,0.7575757575757576,0.7575757575757576,14.393939393939394,12.878787878787879,1.5151515151515151,0
W00007824,127,69,35,34,0,0,46,15,31,12,8,4,0,54.330708661417326,27.559055118110237,26.77165354330709,0,0,36.22047244094488,11.811023622047244,24.409448818897637,9.448818897637794,6.299212598425196,3.149606299212598,0
W00007825,116,104,49,55,8,8,0,0,0,4,2,2,0,89.65517241379311,42.241379310344826,47.41379310344828,6.896551724137931,6.896551724137931,0,0,0,3.4482758620689653,1.7241379310344827,1.7241379310344827,0
W00007826,119,83,37,46,1,1,13,10,3,22,21,1,0,69.74789915966386,31.092436974789916,38.655462184873954,0.8403361344537815,0.8403361344537815,10.92436974789916,8.403361344537815,2.5210084033613445,18.487394957983195,17.647058823529413,0.8403361344537815,0
W00007827,111,70,37,33,34,34,0,0,0,7,5,2,0,63.06306306306306,33.33333333333333,29.72972972972973,30.630630630630627,30.630630630630627,0,0,0,6.306306306306306,4.504504504504505,1.8018018018018018,0
W00007828,145,92,55,37,0,0,41,7,34,11,11,0,1,63.44827586206897,37.93103448275862,25.517241379310345,0,0,28.27586206896552,4.827586206896552,23.448275862068964,7.586206896551724,7.586206896551724,0,0.6896551724137931
W00007829,137,94,42,52,11,11,22,11,11,10,9,1,0,68.61313868613139,30.656934306569344,37.95620437956204,8.02919708029197,8.02919708029197,16.05839416058394,8.02919708029197,8.02919708029197,7.2992700729927,6.569343065693431,0.7299270072992701,0
W00007830,122,69,26,43,1,1,37,14,23,15,14,1,0,56.557377049180324,21.311475409836063,35.24590163934426,0.819672131147541,0.819672131147541,30.327868852459016,11.475409836065573,18.852459016393443,12.295081967213115,11.475409836065573,0.819672131147541,0
W00007831,107,65,29,36,0,0,34,16,18,8,6,2,0,60.747663551401864,27.102803738317753,33.64485981308411,0,0,31.775700934579437,14.953271028037381,16.822429906542055,7.476635514018691,5.607476635514018,1.8691588785046727,0
W00007832,130,82,55,27,1,1,38,14,24,9,8,1,0,63.07692307692307,42.30769230769231,20.76923076923077,0.7692307692307693,0.7692307692307693,29.230769230769234,10.76923076923077,18.461538461538463,6.923076923076923,6.153846153846154,0.7692307692307693,0
W00007833,130,76,34,42,8,8,25,3,22,21,17,4,0,58.46153846153847,26.153846153846157,32.30769230769231,6.153846153846154,6.153846153846154,19.230769230769234,2.307692307692308,16.923076923076923,16.153846153846153,13.076923076923078,3.076923076923077,0
W00007834,120,59,29,30,0,0,54,22,32,7,4,3,0,49.166666666666664,24.166666666666668,25,0,0,45,18.333333333333332,26.666666666666668,5.833333333333333,3.3333333333333335,2.5,0
W00007835,124,68,31,37,2,2,35,17,18,19,16,3,0,54.83870967741935,25,29.838709677419356,1.6129032258064515,1.6129032258064515,28.225806451612907,13.709677419354838,14.516129032258066,15.32258064516129,12.903225806451612,2.4193548387096775,0
W00007836,139,121,52,69,0,0,2,0,2,16,13,3,0,87.05035971223022,37.410071942446045,49.64028776978417,0,0,1.4388489208633095,0,1.4388489208633095,11.510791366906476,9.352517985611511,2.158273381294964,0
W00007837,125,76,35,41,0,0,37,18,19,12,9,3,0,60.8,28.000000000000004,32.800000000000004,0,0,29.599999999999998,14.399999999999999,15.2,9.6,7.199999999999999,2.4,0
W00007838,129,69,34,35,0,0,52,13,39,8,6,2,0,53.48837209302325,26.356589147286826,27.131782945736433,0,0,40.310077519379846,10.077519379844961,30.23255813953488,6.2015503875969,4.651162790697675,1.550387596899225,0
W00007839,138,127,76,51,0,0,2,1,1,9,9,0,0,92.02898550724638,55.072463768115945,36.95652173913043,0,0,1.4492753623188406,0.7246376811594203,0.7246376811594203,6.521739130434782,6.521739130434782,0,0
W00007840,128,71,32,39,2,2,37,16,21,18,13,5,0,55.46875,25,30.46875,1.5625,1.5625,28.90625,12.5,16.40625,14.0625,10.15625,3.90625,0
W00007841,135,70,39,31,0,0,45,17,28,20,17,3,0,51.85185185185185,28.888888888888886,22.962962962962962,0,0,33.33333333333333,12.592592592592592,20.74074074074074,14.814814814814813,12.592592592592592,2.2222222222222223,0
W00007842,112,85,45,40,0,0,0,0,0,27,25,2,0,75.89285714285714,40.17857142857143,35.714285714285715,0,0,0,0,0,24.107142857142858,22.321428571428573,1.7857142857142856,0
W00007843,121,38,18,20,0,0,69,27,42,14,11,3,0,31.40495867768595,14.87603305785124,16.528925619834713,0,0,57.02479338842975,22.31404958677686,34.710743801652896,11.570247933884298,9.090909090909092,2.479338842975207,0
W00007844,130,83,38,45,0,0,30,8,22,17,12,5,0,63.84615384615384,29.230769230769234,34.61538461538461,0,0,23.076923076923077,6.153846153846154,16.923076923076923,13.076923076923078,9.230769230769232,3.8461538461538463,0
W00007845,121,111,56,55,0,0,6,3,3,4,3,1,0,91.73553719008265,46.28099173553719,45.45454545454545,0,0,4.958677685950414,2.479338842975207,2.479338842975207,3.3057851239669422,2.479338842975207,0.8264462809917356,0
W00007846,119,69,31,38,0,0,37,12,25,13,11,2,0,57.98319327731093,26.05042016806723,31.932773109243694,0,0,31.092436974789916,10.084033613445378,21.008403361344538,10.92436974789916,9.243697478991598,1.680672268907563,0
W00007847,120,82,48,34,0,0,33,17,16,5,5,0,0,68.33333333333333,40,28.333333333333332,0,0,27.500000000000004,14.166666666666666,13.333333333333334,4.166666666666666,4.166666666666666,0,0
W00007848,124,59,28,31,0,0,44,21,23,21,17,4,0,47.58064516129033,22.58064516129032,25,0,0,35.483870967741936,16.93548387096774,18.548387096774192,16.93548387096774,13.709677419354838,3.225806451612903,0
W00007849,121,59,27,32,0,0,42,14,28,20,15,5,0,48.760330578512395,22.31404958677686,26.446280991735538,0,0,34.710743801652896,11.570247933884298,23.140495867768596,16.528925619834713,12.396694214876034,4.132231404958678,0
W00007850,108,42,21,21,0,0,42,14,28,24,22,2,0,38.88888888888889,19.444444444444446,19.444444444444446,0,0,38.88888888888889,12.962962962962962,25.925925925925924,22.22222222222222,20.37037037037037,1.8518518518518516,0
W00007851,116,80,38,42,1,1,19,3,16,16,13,3,0,68.96551724137932,32.758620689655174,36.206896551724135,0.8620689655172413,0.8620689655172413,16.379310344827587,2.586206896551724,13.793103448275861,13.793103448275861,11.206896551724139,2.586206896551724,0
W00007852,111,16,10,6,0,0,84,27,57,11,11,0,0,14.414414414414415,9.00900900900901,5.405405405405405,0,0,75.67567567567568,24.324324324324326,51.35135135135135,9.90990990990991,9.90990990990991,0,0
W00007853,219,102,52,50,2,2,83,12,71,32,29,3,0,46.57534246575342,23.74429223744292,22.831050228310502,0.91324200913242,0.91324200913242,37.89954337899543,5.47945205479452,32.42009132420091,14.61187214611872,13.24200913242009,1.36986301369863,0
W00007854,118,29,22,7,0,0,72,31,41,17,17,0,0,24.576271186440678,18.64406779661017,5.932203389830509,0,0,61.016949152542374,26.27118644067797,34.74576271186441,14.40677966101695,14.40677966101695,0,0
W00007855,110,60,40,20,0,0,32,9,23,18,15,3,0,54.54545454545454,36.36363636363637,18.181818181818183,0,0,29.09090909090909,8.181818181818182,20.909090909090907,16.363636363636363,13.636363636363635,2.727272727272727,0
W00007856,100,68,38,30,0,0,18,12,6,14,9,5,0,68,38,30,0,0,18,12,6,14.000000000000002,9,5,0
W00007857,168,146,90,56,0,0,1,0,1,21,17,4,0,86.90476190476191,53.57142857142857,33.33333333333333,0,0,0.5952380952380952,0,0.5952380952380952,12.5,10.119047619047619,2.380952380952381,0
W00007859,124,75,43,32,1,1,30,4,26,18,18,0,0,60.483870967741936,34.67741935483871,25.806451612903224,0.8064516129032258,0.8064516129032258,24.193548387096776,3.225806451612903,20.967741935483872,14.516129032258066,14.516129032258066,0,0
W00007860,131,56,25,31,0,0,63,26,37,12,11,1,0,42.74809160305343,19.083969465648856,23.66412213740458,0,0,48.091603053435115,19.84732824427481,28.24427480916031,9.16030534351145,8.396946564885496,0.7633587786259541,0
W00007861,156,119,63,56,0,0,25,8,17,12,6,6,0,76.28205128205127,40.38461538461539,35.8974358974359,0,0,16.025641025641026,5.128205128205128,10.897435897435898,7.6923076923076925,3.8461538461538463,3.8461538461538463,0
W00007863,151,74,38,36,0,0,62,20,42,15,10,5,0,49.00662251655629,25.165562913907287,23.841059602649008,0,0,41.05960264900662,13.245033112582782,27.81456953642384,9.933774834437086,6.622516556291391,3.3112582781456954,0
W00007864,133,73,36,37,1,1,48,20,28,10,8,2,1,54.88721804511278,27.06766917293233,27.819548872180448,0.7518796992481203,0.7518796992481203,36.09022556390977,15.037593984962406,21.052631578947366,7.518796992481203,6.015037593984962,1.5037593984962405,0.7518796992481203
W00007865,126,82,28,54,0,0,28,9,19,16,13,3,0,65.07936507936508,22.22222222222222,42.857142857142854,0,0,22.22222222222222,7.142857142857142,15.079365079365079,12.698412698412698,10.317460317460316,2.380952380952381,0
W00007866,150,91,36,55,2,2,38,4,34,19,12,7,0,60.66666666666667,24,36.666666666666664,1.3333333333333335,1.3333333333333335,25.333333333333336,2.666666666666667,22.666666666666664,12.666666666666668,8,4.666666666666667,0
W00007868,120,70,41,29,0,0,42,5,37,8,5,3,0,58.333333333333336,34.166666666666664,24.166666666666668,0,0,35,4.166666666666666,30.833333333333336,6.666666666666667,4.166666666666666,2.5,0
W00007869,135,104,69,35,0,0,18,5,13,13,11,2,0,77.03703703703704,51.11111111111111,25.925925925925924,0,0,13.333333333333334,3.7037037037037033,9.62962962962963,9.62962962962963,8.148148148148149,1.4814814814814816,0
W00007870,127,97,57,40,0,0,15,4,11,15,12,3,0,76.37795275590551,44.881889763779526,31.496062992125985,0,0,11.811023622047244,3.149606299212598,8.661417322834646,11.811023622047244,9.448818897637794,2.3622047244094486,0
W00007871,124,80,45,35,0,0,24,12,12,20,16,4,0,64.51612903225806,36.29032258064516,28.225806451612907,0,0,19.35483870967742,9.67741935483871,9.67741935483871,16.129032258064516,12.903225806451612,3.225806451612903,0
W00007872,122,97,61,36,0,0,8,3,5,17,15,2,0,79.50819672131148,50,29.508196721311474,0,0,6.557377049180328,2.459016393442623,4.098360655737705,13.934426229508196,12.295081967213115,1.639344262295082,0
W00007873,122,85,45,40,0,0,18,5,13,19,14,5,0,69.67213114754098,36.885245901639344,32.78688524590164,0,0,14.754098360655737,4.098360655737705,10.655737704918032,15.573770491803279,11.475409836065573,4.098360655737705,0
W00007874,122,90,50,40,0,0,15,5,10,17,12,5,0,73.77049180327869,40.98360655737705,32.78688524590164,0,0,12.295081967213115,4.098360655737705,8.19672131147541,13.934426229508196,9.836065573770492,4.098360655737705,0
W00007875,114,74,52,22,0,0,20,11,9,20,14,6,0,64.91228070175438,45.614035087719294,19.298245614035086,0,0,17.543859649122805,9.649122807017543,7.894736842105263,17.543859649122805,12.280701754385964,5.263157894736842,0
W00007876,131,110,73,37,1,1,7,4,3,13,11,2,0,83.96946564885496,55.72519083969466,28.24427480916031,0.7633587786259541,0.7633587786259541,5.343511450381679,3.0534351145038165,2.2900763358778624,9.923664122137405,8.396946564885496,1.5267175572519083,0
W00007877,136,130,77,53,0,0,0,0,0,5,3,2,1,95.58823529411765,56.61764705882353,38.970588235294116,0,0,0,0,0,3.6764705882352944,2.2058823529411766,1.4705882352941175,0.7352941176470588
W00007878,135,106,67,39,2,2,15,6,9,12,10,2,0,78.51851851851852,49.629629629629626,28.888888888888886,1.4814814814814816,1.4814814814814816,11.11111111111111,4.444444444444445,6.666666666666667,8.88888888888889,7.4074074074074066,1.4814814814814816,0
W00007879,162,159,108,51,0,0,0,0,0,3,3,0,0,98.14814814814815,66.66666666666666,31.48148148148148,0,0,0,0,0,1.8518518518518516,1.8518518518518516,0,0
W00007880,51,43,27,16,0,0,2,1,1,6,4,2,0,84.31372549019608,52.94117647058824,31.372549019607842,0,0,3.9215686274509802,1.9607843137254901,1.9607843137254901,11.76470588235294,7.8431372549019605,3.9215686274509802,0
W00007881,133,107,72,35,0,0,17,8,9,9,9,0,0,80.45112781954887,54.13533834586466,26.31578947368421,0,0,12.781954887218044,6.015037593984962,6.7669172932330826,6.7669172932330826,6.7669172932330826,0,0
W00007882,120,112,64,48,0,0,2,0,2,6,6,0,0,93.33333333333333,53.333333333333336,40,0,0,1.6666666666666667,0,1.6666666666666667,5,5,0,0
W00007883,138,128,79,49,0,0,3,0,3,7,5,2,0,92.7536231884058,57.2463768115942,35.507246376811594,0,0,2.1739130434782608,0,2.1739130434782608,5.072463768115942,3.6231884057971016,1.4492753623188406,0
W00007884,139,71,50,21,1,1,62,9,53,5,4,1,0,51.07913669064749,35.97122302158273,15.107913669064748,0.7194244604316548,0.7194244604316548,44.60431654676259,6.474820143884892,38.1294964028777,3.5971223021582732,2.877697841726619,0.7194244604316548,0
W00007885,116,110,80,30,0,0,0,0,0,6,4,2,0,94.82758620689656,68.96551724137932,25.862068965517242,0,0,0,0,0,5.172413793103448,3.4482758620689653,1.7241379310344827,0
W00007886,119,106,73,33,1,1,6,0,6,6,4,2,0,89.07563025210085,61.34453781512605,27.73109243697479,0.8403361344537815,0.8403361344537815,5.042016806722689,0,5.042016806722689,5.042016806722689,3.361344537815126,1.680672268907563,0
W00007887,134,124,79,45,1,1,4,2,2,5,3,2,0,92.53731343283582,58.95522388059702,33.582089552238806,0.7462686567164178,0.7462686567164178,2.9850746268656714,1.4925373134328357,1.4925373134328357,3.731343283582089,2.2388059701492535,1.4925373134328357,0
W00007888,110,65,47,18,0,0,32,13,19,13,11,2,0,59.09090909090909,42.72727272727273,16.363636363636363,0,0,29.09090909090909,11.818181818181818,17.272727272727273,11.818181818181818,10,1.8181818181818181,0
W00007889,122,97,51,46,0,0,17,2,15,8,7,1,0,79.50819672131148,41.80327868852459,37.704918032786885,0,0,13.934426229508196,1.639344262295082,12.295081967213115,6.557377049180328,5.737704918032787,0.819672131147541,0
W00007890,126,86,45,41,1,1,30,7,23,8,3,5,1,68.25396825396825,35.714285714285715,32.53968253968254,0.7936507936507936,0.7936507936507936,23.809523809523807,5.555555555555555,18.253968253968253,6.349206349206349,2.380952380952381,3.968253968253968,0.7936507936507936
W00007891,118,70,38,32,1,1,24,7,17,23,21,2,0,59.32203389830508,32.20338983050847,27.11864406779661,0.847457627118644,0.847457627118644,20.33898305084746,5.932203389830509,14.40677966101695,19.491525423728813,17.796610169491526,1.694915254237288,0
W00007892,110,40,18,22,1,1,60,8,52,8,4,4,1,36.36363636363637,16.363636363636363,20,0.9090909090909091,0.9090909090909091,54.54545454545454,7.2727272727272725,47.27272727272727,7.2727272727272725,3.6363636363636362,3.6363636363636362,0.9090909090909091
W00007893,128,106,68,38,0,0,2,0,2,20,19,1,0,82.8125,53.125,29.6875,0,0,1.5625,0,1.5625,15.625,14.84375,0.78125,0
W00007894,133,110,61,49,1,1,3,1,2,19,13,6,0,82.70676691729322,45.86466165413533,36.84210526315789,0.7518796992481203,0.7518796992481203,2.2556390977443606,0.7518796992481203,1.5037593984962405,14.285714285714285,9.774436090225564,4.511278195488721,0
W00007895,220,181,98,83,4,4,16,8,8,19,17,2,0,82.27272727272728,44.54545454545455,37.72727272727273,1.8181818181818181,1.8181818181818181,7.2727272727272725,3.6363636363636362,3.6363636363636362,8.636363636363637,7.727272727272727,0.9090909090909091,0
W00007896,119,33,20,13,0,0,72,28,44,14,13,1,0,27.73109243697479,16.80672268907563,10.92436974789916,0,0,60.50420168067227,23.52941176470588,36.97478991596639,11.76470588235294,10.92436974789916,0.8403361344537815,0
W00007897,112,106,69,37,0,0,3,0,3,3,2,1,0,94.64285714285714,61.60714285714286,33.035714285714285,0,0,2.6785714285714284,0,2.6785714285714284,2.6785714285714284,1.7857142857142856,0.8928571428571428,0
W00007898,129,115,71,44,0,0,1,1,0,13,7,6,0,89.14728682170544,55.03875968992248,34.10852713178294,0,0,0.7751937984496124,0.7751937984496124,0,10.077519379844961,5.426356589147287,4.651162790697675,0
W00007899,127,107,74,33,0,0,2,2,0,18,17,1,0,84.25196850393701,58.26771653543307,25.984251968503933,0,0,1.574803149606299,1.574803149606299,0,14.173228346456693,13.385826771653544,0.7874015748031495,0
W00007900,119,112,61,51,0,0,2,2,0,5,4,1,0,94.11764705882352,51.26050420168067,42.857142857142854,0,0,1.680672268907563,1.680672268907563,0,4.201680672268908,3.361344537815126,0.8403361344537815,0
W00007901,119,115,75,40,1,1,1,1,0,2,2,0,0,96.63865546218487,63.02521008403361,33.61344537815126,0.8403361344537815,0.8403361344537815,0.8403361344537815,0.8403361344537815,0,1.680672268907563,1.680672268907563,0,0
W00007902,133,118,78,40,0,0,4,1,3,11,11,0,0,88.7218045112782,58.64661654135338,30.075187969924812,0,0,3.007518796992481,0.7518796992481203,2.2556390977443606,8.270676691729323,8.270676691729323,0,0
W00007903,139,132,73,59,0,0,2,0,2,5,4,1,0,94.96402877697841,52.51798561151079,42.44604316546763,0,0,1.4388489208633095,0,1.4388489208633095,3.5971223021582732,2.877697841726619,0.7194244604316548,0
W00007904,122,116,80,36,0,0,1,0,1,5,5,0,0,95.08196721311475,65.57377049180327,29.508196721311474,0,0,0.819672131147541,0,0.819672131147541,4.098360655737705,4.098360655737705,0,0
W00007905,144,96,41,55,0,0,10,2,8,38,35,3,0,66.66666666666666,28.47222222222222,38.19444444444444,0,0,6.944444444444445,1.3888888888888888,5.555555555555555,26.38888888888889,24.305555555555554,2.083333333333333,0
W00007906,122,77,46,31,0,0,32,17,15,13,11,2,0,63.114754098360656,37.704918032786885,25.40983606557377,0,0,26.229508196721312,13.934426229508196,12.295081967213115,10.655737704918032,9.01639344262295,1.639344262295082,0
W00007907,123,91,51,40,0,0,5,3,2,27,26,1,0,73.98373983739837,41.46341463414634,32.52032520325203,0,0,4.0650406504065035,2.4390243902439024,1.6260162601626018,21.951219512195124,21.138211382113823,0.8130081300813009,0
W00007908,124,119,86,33,2,2,2,1,1,1,1,0,0,95.96774193548387,69.35483870967742,26.61290322580645,1.6129032258064515,1.6129032258064515,1.6129032258064515,0.8064516129032258,0.8064516129032258,0.8064516129032258,0.8064516129032258,0,0
W00007909,127,85,46,39,0,0,29,3,26,13,9,4,0,66.92913385826772,36.22047244094488,30.708661417322837,0,0,22.83464566929134,2.3622047244094486,20.47244094488189,10.236220472440944,7.086614173228346,3.149606299212598,0
W00007910,126,104,60,44,4,4,1,0,1,17,14,3,0,82.53968253968253,47.61904761904761,34.92063492063492,3.1746031746031744,3.1746031746031744,0.7936507936507936,0,0.7936507936507936,13.492063492063492,11.11111111111111,2.380952380952381,0
W00007911,116,89,52,37,2,2,13,2,11,12,11,1,0,76.72413793103449,44.827586206896555,31.896551724137932,1.7241379310344827,1.7241379310344827,11.206896551724139,1.7241379310344827,9.482758620689655,10.344827586206897,9.482758620689655,0.8620689655172413,0
W00007912,140,116,67,49,2,2,5,0,5,17,16,1,0,82.85714285714286,47.85714285714286,35,1.4285714285714286,1.4285714285714286,3.571428571428571,0,3.571428571428571,12.142857142857142,11.428571428571429,0.7142857142857143,0
W00007913,133,109,66,43,0,0,14,5,9,10,6,4,0,81.95488721804512,49.62406015037594,32.33082706766917,0,0,10.526315789473683,3.7593984962406015,6.7669172932330826,7.518796992481203,4.511278195488721,3.007518796992481,0
W00007914,139,82,38,44,1,1,34,11,23,22,19,3,0,58.992805755395686,27.33812949640288,31.654676258992804,0.7194244604316548,0.7194244604316548,24.46043165467626,7.913669064748201,16.546762589928058,15.827338129496402,13.66906474820144,2.158273381294964,0
W00007915,111,98,63,35,0,0,8,2,6,5,1,4,0,88.28828828828829,56.75675675675676,31.53153153153153,0,0,7.207207207207207,1.8018018018018018,5.405405405405405,4.504504504504505,0.9009009009009009,3.6036036036036037,0
W00007916,119,98,54,44,0,0,15,6,9,6,5,1,0,82.35294117647058,45.378151260504204,36.97478991596639,0,0,12.605042016806722,5.042016806722689,7.563025210084033,5.042016806722689,4.201680672268908,0.8403361344537815,0
W00007918,121,73,41,32,0,0,37,16,21,11,7,4,0,60.33057851239669,33.88429752066116,26.446280991735538,0,0,30.57851239669421,13.223140495867769,17.355371900826448,9.090909090909092,5.785123966942149,3.3057851239669422,0
W00007919,110,54,24,30,0,0,43,13,30,13,8,5,0,49.09090909090909,21.818181818181817,27.27272727272727,0,0,39.09090909090909,11.818181818181818,27.27272727272727,11.818181818181818,7.2727272727272725,4.545454545454546,0
W00007920,126,101,56,45,0,0,7,4,3,18,16,2,0,80.15873015873017,44.44444444444444,35.714285714285715,0,0,5.555555555555555,3.1746031746031744,2.380952380952381,14.285714285714285,12.698412698412698,1.5873015873015872,0
W00007921,120,72,47,25,0,0,38,13,25,8,8,0,2,60,39.166666666666664,20.833333333333336,0,0,31.666666666666664,10.833333333333334,20.833333333333336,6.666666666666667,6.666666666666667,0,1.6666666666666667
W00007922,157,63,40,23,1,1,82,35,47,11,9,2,0,40.12738853503185,25.477707006369428,14.64968152866242,0.6369426751592357,0.6369426751592357,52.22929936305732,22.29299363057325,29.936305732484076,7.006369426751593,5.7324840764331215,1.2738853503184715,0
W00007923,116,98,57,41,0,0,4,1,3,14,10,4,0,84.48275862068965,49.137931034482754,35.3448275862069,0,0,3.4482758620689653,0.8620689655172413,2.586206896551724,12.068965517241379,8.620689655172415,3.4482758620689653,0
W00007924,121,95,65,30,0,0,10,3,7,16,12,4,0,78.51239669421489,53.71900826446281,24.793388429752067,0,0,8.264462809917356,2.479338842975207,5.785123966942149,13.223140495867769,9.917355371900827,3.3057851239669422,0
W00007925,129,71,28,43,0,0,2,1,1,56,48,8,0,55.03875968992248,21.705426356589147,33.33333333333333,0,0,1.550387596899225,0.7751937984496124,0.7751937984496124,43.41085271317829,37.2093023255814,6.2015503875969,0
W00007926,122,103,67,36,2,2,10,5,5,7,3,4,0,84.42622950819673,54.91803278688525,29.508196721311474,1.639344262295082,1.639344262295082,8.19672131147541,4.098360655737705,4.098360655737705,5.737704918032787,2.459016393442623,3.278688524590164,0
W00007927,127,106,53,53,1,1,1,0,1,19,15,4,0,83.46456692913385,41.732283464566926,41.732283464566926,0.7874015748031495,0.7874015748031495,0.7874015748031495,0,0.7874015748031495,14.960629921259844,11.811023622047244,3.149606299212598,0
W00007928,133,60,31,29,0,0,48,18,30,24,21,3,1,45.11278195488722,23.308270676691727,21.804511278195488,0,0,36.09022556390977,13.533834586466165,22.55639097744361,18.045112781954884,15.789473684210526,2.2556390977443606,0.7518796992481203
W00007929,76,10,5,5,0,0,64,3,61,2,2,0,0,13.157894736842104,6.578947368421052,6.578947368421052,0,0,84.21052631578947,3.9473684210526314,80.26315789473685,2.631578947368421,2.631578947368421,0,0
W00007930,138,52,28,24,0,0,58,25,33,28,24,4,0,37.68115942028986,20.28985507246377,17.391304347826086,0,0,42.028985507246375,18.115942028985508,23.91304347826087,20.28985507246377,17.391304347826086,2.898550724637681,0
W00007931,121,31,17,14,2,2,67,22,45,20,18,2,1,25.6198347107438,14.049586776859504,11.570247933884298,1.6528925619834711,1.6528925619834711,55.371900826446286,18.181818181818183,37.1900826446281,16.528925619834713,14.87603305785124,1.6528925619834711,0.8264462809917356
W00007932,131,39,23,16,1,1,63,26,37,28,25,3,0,29.770992366412212,17.557251908396946,12.213740458015266,0.7633587786259541,0.7633587786259541,48.091603053435115,19.84732824427481,28.24427480916031,21.374045801526716,19.083969465648856,2.2900763358778624,0
W00007933,123,64,31,33,0,0,53,23,30,5,3,2,1,52.03252032520326,25.203252032520325,26.82926829268293,0,0,43.08943089430895,18.69918699186992,24.390243902439025,4.0650406504065035,2.4390243902439024,1.6260162601626018,0.8130081300813009
W00007934,118,81,50,31,0,0,28,10,18,9,6,3,0,68.64406779661016,42.3728813559322,26.27118644067797,0,0,23.728813559322035,8.47457627118644,15.254237288135593,7.627118644067797,5.084745762711865,2.5423728813559325,0
W00007935,208,129,66,63,1,1,16,5,11,62,56,6,0,62.019230769230774,31.73076923076923,30.288461538461537,0.4807692307692308,0.4807692307692308,7.6923076923076925,2.403846153846154,5.288461538461538,29.807692307692307,26.923076923076923,2.8846153846153846,0
W00007936,129,70,38,32,1,1,53,20,33,5,5,0,0,54.263565891472865,29.457364341085274,24.8062015503876,0.7751937984496124,0.7751937984496124,41.08527131782946,15.503875968992247,25.581395348837212,3.875968992248062,3.875968992248062,0,0
W00007937,111,60,23,37,0,0,43,16,27,8,6,2,0,54.054054054054056,20.72072072072072,33.33333333333333,0,0,38.73873873873874,14.414414414414415,24.324324324324326,7.207207207207207,5.405405405405405,1.8018018018018018,0
W00007938,132,98,53,45,0,0,10,6,4,24,20,4,0,74.24242424242425,40.15151515151515,34.090909090909086,0,0,7.575757575757576,4.545454545454546,3.0303030303030303,18.181818181818183,15.151515151515152,3.0303030303030303,0
W00007939,118,96,49,47,0,0,14,6,8,8,5,3,0,81.35593220338984,41.52542372881356,39.83050847457627,0,0,11.864406779661017,5.084745762711865,6.779661016949152,6.779661016949152,4.23728813559322,2.5423728813559325,0
W00007940,131,28,12,16,0,0,85,20,65,17,15,2,1,21.374045801526716,9.16030534351145,12.213740458015266,0,0,64.8854961832061,15.267175572519085,49.61832061068702,12.977099236641221,11.450381679389313,1.5267175572519083,0.7633587786259541
W00007941,127,86,44,42,1,1,30,13,17,10,10,0,0,67.71653543307087,34.645669291338585,33.07086614173229,0.7874015748031495,0.7874015748031495,23.62204724409449,10.236220472440944,13.385826771653544,7.874015748031496,7.874015748031496,0,0
W00007942,128,68,40,28,0,0,42,10,32,18,14,4,0,53.125,31.25,21.875,0,0,32.8125,7.8125,25,14.0625,10.9375,3.125,0
W00007943,116,77,35,42,1,1,6,5,1,31,28,3,1,66.37931034482759,30.17241379310345,36.206896551724135,0.8620689655172413,0.8620689655172413,5.172413793103448,4.310344827586207,0.8620689655172413,26.72413793103448,24.137931034482758,2.586206896551724,0.8620689655172413
W00007944,122,85,39,46,0,0,21,14,7,16,15,1,0,69.67213114754098,31.967213114754102,37.704918032786885,0,0,17.21311475409836,11.475409836065573,5.737704918032787,13.114754098360656,12.295081967213115,0.819672131147541,0
W00007945,119,58,36,22,5,5,38,16,22,18,12,6,0,48.739495798319325,30.252100840336134,18.487394957983195,4.201680672268908,4.201680672268908,31.932773109243694,13.445378151260504,18.487394957983195,15.126050420168067,10.084033613445378,5.042016806722689,0
W00007946,126,62,32,30,1,1,44,14,30,19,16,3,0,49.2063492063492,25.396825396825395,23.809523809523807,0.7936507936507936,0.7936507936507936,34.92063492063492,11.11111111111111,23.809523809523807,15.079365079365079,12.698412698412698,2.380952380952381,0
W00007948,122,59,36,23,1,1,57,5,52,5,4,1,0,48.36065573770492,29.508196721311474,18.852459016393443,0.819672131147541,0.819672131147541,46.72131147540984,4.098360655737705,42.62295081967213,4.098360655737705,3.278688524590164,0.819672131147541,0
W00007949,120,81,50,31,0,0,24,5,19,15,11,4,0,67.5,41.66666666666667,25.833333333333336,0,0,20,4.166666666666666,15.833333333333332,12.5,9.166666666666666,3.3333333333333335,0
W00007950,130,82,50,32,2,2,16,4,12,30,28,2,0,63.07692307692307,38.46153846153847,24.615384615384617,1.5384615384615385,1.5384615384615385,12.307692307692308,3.076923076923077,9.230769230769232,23.076923076923077,21.53846153846154,1.5384615384615385,0
W00007951,133,75,41,34,3,3,37,9,28,18,16,2,0,56.390977443609025,30.82706766917293,25.563909774436087,2.2556390977443606,2.2556390977443606,27.819548872180448,6.7669172932330826,21.052631578947366,13.533834586466165,12.030075187969924,1.5037593984962405,0
W00007952,127,87,44,43,1,1,3,0,3,36,31,5,0,68.50393700787401,34.645669291338585,33.85826771653544,0.7874015748031495,0.7874015748031495,2.3622047244094486,0,2.3622047244094486,28.346456692913385,24.409448818897637,3.937007874015748,0
W00007953,124,89,42,47,2,2,3,0,3,30,23,7,0,71.7741935483871,33.87096774193548,37.903225806451616,1.6129032258064515,1.6129032258064515,2.4193548387096775,0,2.4193548387096775,24.193548387096776,18.548387096774192,5.64516129032258,0
W00007954,141,98,54,44,0,0,25,9,16,18,17,1,0,69.50354609929079,38.297872340425535,31.20567375886525,0,0,17.73049645390071,6.382978723404255,11.347517730496454,12.76595744680851,12.056737588652481,0.7092198581560284,0
W00007955,163,74,42,32,10,10,58,11,47,21,16,5,0,45.39877300613497,25.766871165644172,19.631901840490798,6.134969325153374,6.134969325153374,35.58282208588957,6.748466257668712,28.834355828220858,12.883435582822086,9.815950920245399,3.067484662576687,0
W00007956,138,129,76,53,0,0,0,0,0,9,9,0,0,93.47826086956522,55.072463768115945,38.405797101449274,0,0,0,0,0,6.521739130434782,6.521739130434782,0,0
W00007957,143,70,38,32,1,1,23,4,19,49,43,6,0,48.95104895104895,26.573426573426573,22.377622377622377,0.6993006993006993,0.6993006993006993,16.083916083916083,2.797202797202797,13.286713286713287,34.26573426573427,30.069930069930066,4.195804195804196,0
W00007958,183,48,17,31,2,2,75,22,53,58,58,0,0,26.229508196721312,9.289617486338798,16.939890710382514,1.092896174863388,1.092896174863388,40.98360655737705,12.021857923497267,28.96174863387978,31.693989071038253,31.693989071038253,0,0
W00007959,128,97,62,35,1,1,18,5,13,12,12,0,0,75.78125,48.4375,27.34375,0.78125,0.78125,14.0625,3.90625,10.15625,9.375,9.375,0,0
W00007960,115,48,27,21,0,0,61,28,33,3,1,2,3,41.73913043478261,23.47826086956522,18.26086956521739,0,0,53.04347826086957,24.347826086956523,28.695652173913043,2.608695652173913,0.8695652173913043,1.7391304347826086,2.608695652173913
W00007961,153,119,53,66,1,1,26,15,11,7,4,3,0,77.77777777777779,34.64052287581699,43.13725490196079,0.6535947712418301,0.6535947712418301,16.99346405228758,9.803921568627452,7.18954248366013,4.57516339869281,2.6143790849673203,1.9607843137254901,0
W00007962,125,72,43,29,1,1,45,10,35,7,7,0,0,57.599999999999994,34.4,23.200000000000003,0.8,0.8,36,8,28.000000000000004,5.6000000000000005,5.6000000000000005,0,0
W00007963,215,144,68,76,3,3,52,18,34,16,13,3,0,66.97674418604652,31.627906976744185,35.348837209302324,1.3953488372093024,1.3953488372093024,24.186046511627907,8.372093023255815,15.813953488372093,7.441860465116279,6.046511627906977,1.3953488372093024,0
W00007964,110,69,44,25,0,0,33,15,18,7,5,2,1,62.727272727272734,40,22.727272727272727,0,0,30,13.636363636363635,16.363636363636363,6.363636363636363,4.545454545454546,1.8181818181818181,0.9090909090909091
W00007965,143,76,40,36,9,9,33,6,27,25,16,9,0,53.14685314685315,27.972027972027973,25.174825174825177,6.293706293706294,6.293706293706294,23.076923076923077,4.195804195804196,18.88111888111888,17.482517482517483,11.188811188811188,6.293706293706294,0
W00007966,125,67,40,27,0,0,47,22,25,11,7,4,0,53.6,32,21.6,0,0,37.6,17.599999999999998,20,8.799999999999999,5.6000000000000005,3.2,0
W00007967,129,91,52,39,0,0,26,5,21,12,9,3,0,70.54263565891473,40.310077519379846,30.23255813953488,0,0,20.155038759689923,3.875968992248062,16.27906976744186,9.30232558139535,6.976744186046512,2.3255813953488373,0
W00007969,131,88,46,42,3,3,20,8,12,20,19,1,0,67.17557251908397,35.11450381679389,32.06106870229007,2.2900763358778624,2.2900763358778624,15.267175572519085,6.106870229007633,9.16030534351145,15.267175572519085,14.50381679389313,0.7633587786259541,0
W00007970,117,78,44,34,1,1,22,8,14,15,9,6,1,66.66666666666666,37.60683760683761,29.059829059829063,0.8547008547008548,0.8547008547008548,18.803418803418804,6.837606837606838,11.965811965811966,12.82051282051282,7.6923076923076925,5.128205128205128,0.8547008547008548
W00007971,104,39,24,15,0,0,58,28,30,7,7,0,0,37.5,23.076923076923077,14.423076923076922,0,0,55.769230769230774,26.923076923076923,28.846153846153843,6.730769230769231,6.730769230769231,0,0
W00007972,108,56,25,31,0,0,43,21,22,9,7,2,0,51.85185185185185,23.14814814814815,28.703703703703702,0,0,39.81481481481482,19.444444444444446,20.37037037037037,8.333333333333332,6.481481481481481,1.8518518518518516,0
W00007973,102,36,17,19,0,0,61,35,26,5,4,1,0,35.294117647058826,16.666666666666664,18.627450980392158,0,0,59.80392156862745,34.31372549019608,25.49019607843137,4.901960784313726,3.9215686274509802,0.9803921568627451,0
W00007974,119,36,23,13,0,0,73,26,47,10,7,3,0,30.252100840336134,19.327731092436977,10.92436974789916,0,0,61.34453781512605,21.84873949579832,39.49579831932773,8.403361344537815,5.88235294117647,2.5210084033613445,0
W00007975,132,72,41,31,0,0,37,12,25,23,19,4,0,54.54545454545454,31.060606060606062,23.484848484848484,0,0,28.030303030303028,9.090909090909092,18.939393939393938,17.424242424242426,14.393939393939394,3.0303030303030303,0
W00007976,122,50,34,16,0,0,58,19,39,14,13,1,0,40.98360655737705,27.86885245901639,13.114754098360656,0,0,47.540983606557376,15.573770491803279,31.967213114754102,11.475409836065573,10.655737704918032,0.819672131147541,0
W00007977,132,64,36,28,1,1,54,23,31,12,12,0,1,48.484848484848484,27.27272727272727,21.21212121212121,0.7575757575757576,0.7575757575757576,40.909090909090914,17.424242424242426,23.484848484848484,9.090909090909092,9.090909090909092,0,0.7575757575757576
W00007978,112,35,25,10,0,0,62,21,41,15,13,2,0,31.25,22.321428571428573,8.928571428571429,0,0,55.35714285714286,18.75,36.607142857142854,13.392857142857142,11.607142857142858,1.7857142857142856,0
W00007979,150,124,67,57,0,0,10,1,9,16,15,1,0,82.66666666666667,44.666666666666664,38,0,0,6.666666666666667,0.6666666666666667,6,10.666666666666668,10,0.6666666666666667,0
W00007980,111,56,36,20,0,0,33,10,23,22,20,2,0,50.45045045045045,32.432432432432435,18.01801801801802,0,0,29.72972972972973,9.00900900900901,20.72072072072072,19.81981981981982,18.01801801801802,1.8018018018018018,0
W00007981,131,98,50,48,0,0,6,1,5,27,22,5,0,74.80916030534351,38.16793893129771,36.6412213740458,0,0,4.580152671755725,0.7633587786259541,3.816793893129771,20.610687022900763,16.793893129770993,3.816793893129771,0
W00007982,130,26,20,6,0,0,92,38,54,12,11,1,0,20,15.384615384615385,4.615384615384616,0,0,70.76923076923077,29.230769230769234,41.53846153846154,9.230769230769232,8.461538461538462,0.7692307692307693,0
W00007983,133,90,51,39,0,0,35,7,28,8,5,3,0,67.66917293233082,38.34586466165413,29.32330827067669,0,0,26.31578947368421,5.263157894736842,21.052631578947366,6.015037593984962,3.7593984962406015,2.2556390977443606,0
W00007984,144,35,20,15,0,0,96,37,59,13,11,2,0,24.305555555555554,13.88888888888889,10.416666666666668,0,0,66.66666666666666,25.694444444444443,40.97222222222222,9.027777777777777,7.638888888888889,1.3888888888888888,0
W00007985,149,109,59,50,0,0,21,2,19,19,16,3,0,73.15436241610739,39.59731543624161,33.557046979865774,0,0,14.093959731543624,1.342281879194631,12.751677852348994,12.751677852348994,10.738255033557047,2.013422818791946,0
W00007986,121,54,31,23,1,1,65,23,42,1,1,0,0,44.62809917355372,25.6198347107438,19.00826446280992,0.8264462809917356,0.8264462809917356,53.71900826446281,19.00826446280992,34.710743801652896,0.8264462809917356,0.8264462809917356,0,0
W00007987,129,97,44,53,0,0,13,3,10,19,15,4,0,75.1937984496124,34.10852713178294,41.08527131782946,0,0,10.077519379844961,2.3255813953488373,7.751937984496124,14.728682170542637,11.627906976744185,3.10077519379845,0
W00007988,113,47,32,15,0,0,53,24,29,13,11,2,0,41.5929203539823,28.31858407079646,13.274336283185843,0,0,46.902654867256636,21.238938053097346,25.663716814159294,11.504424778761061,9.734513274336283,1.7699115044247788,0
W00007989,108,41,18,23,0,0,57,23,34,9,7,2,1,37.96296296296296,16.666666666666664,21.296296296296298,0,0,52.77777777777778,21.296296296296298,31.48148148148148,8.333333333333332,6.481481481481481,1.8518518518518516,0.9259259259259258
W00007990,120,81,38,43,1,1,20,6,14,18,14,4,0,67.5,31.666666666666664,35.833333333333336,0.8333333333333334,0.8333333333333334,16.666666666666664,5,11.666666666666666,15,11.666666666666666,3.3333333333333335,0
W00007991,118,76,47,29,0,0,31,13,18,11,5,6,0,64.40677966101694,39.83050847457627,24.576271186440678,0,0,26.27118644067797,11.016949152542372,15.254237288135593,9.322033898305085,4.23728813559322,5.084745762711865,0
W00007992,114,52,27,25,0,0,49,17,32,13,8,5,0,45.614035087719294,23.684210526315788,21.929824561403507,0,0,42.98245614035088,14.912280701754385,28.07017543859649,11.403508771929824,7.017543859649122,4.385964912280701,0
W00007993,109,42,22,20,1,1,47,26,21,19,17,2,0,38.53211009174312,20.18348623853211,18.34862385321101,0.9174311926605505,0.9174311926605505,43.11926605504588,23.853211009174313,19.26605504587156,17.431192660550458,15.59633027522936,1.834862385321101,0
W00007994,113,66,41,25,0,0,43,19,24,4,4,0,0,58.4070796460177,36.283185840707965,22.123893805309734,0,0,38.05309734513274,16.8141592920354,21.238938053097346,3.5398230088495577,3.5398230088495577,0,0
W00007995,116,37,17,20,1,1,72,38,34,6,5,1,0,31.896551724137932,14.655172413793101,17.24137931034483,0.8620689655172413,0.8620689655172413,62.06896551724138,32.758620689655174,29.310344827586203,5.172413793103448,4.310344827586207,0.8620689655172413,0
W00007996,108,16,7,9,0,0,87,36,51,4,3,1,1,14.814814814814813,6.481481481481481,8.333333333333332,0,0,80.55555555555556,33.33333333333333,47.22222222222222,3.7037037037037033,2.7777777777777777,0.9259259259259258,0.9259259259259258
W00007997,118,25,9,16,1,1,87,37,50,3,3,0,2,21.1864406779661,7.627118644067797,13.559322033898304,0.847457627118644,0.847457627118644,73.72881355932203,31.35593220338983,42.3728813559322,2.5423728813559325,2.5423728813559325,0,1.694915254237288
W00007998,111,67,45,22,1,1,30,17,13,12,11,1,1,60.36036036036037,40.54054054054054,19.81981981981982,0.9009009009009009,0.9009009009009009,27.027027027027028,15.315315315315313,11.711711711711711,10.81081081081081,9.90990990990991,0.9009009009009009,0.9009009009009009
W00007999,124,77,43,34,0,0,33,18,15,14,8,6,0,62.096774193548384,34.67741935483871,27.419354838709676,0,0,26.61290322580645,14.516129032258066,12.096774193548388,11.29032258064516,6.451612903225806,4.838709677419355,0
W00008000,124,66,32,34,0,0,37,15,22,21,13,8,0,53.2258064516129,25.806451612903224,27.419354838709676,0,0,29.838709677419356,12.096774193548388,17.741935483870968,16.93548387096774,10.483870967741936,6.451612903225806,0
W00008001,136,72,26,46,0,0,51,25,26,13,8,5,0,52.94117647058824,19.11764705882353,33.82352941176471,0,0,37.5,18.38235294117647,19.11764705882353,9.558823529411764,5.88235294117647,3.6764705882352944,0
W00008002,129,55,21,34,0,0,63,25,38,11,10,1,0,42.63565891472868,16.27906976744186,26.356589147286826,0,0,48.837209302325576,19.379844961240313,29.457364341085274,8.527131782945736,7.751937984496124,0.7751937984496124,0
W00008003,128,41,16,25,1,1,76,22,54,10,8,2,0,32.03125,12.5,19.53125,0.78125,0.78125,59.375,17.1875,42.1875,7.8125,6.25,1.5625,0
W00008004,112,93,54,39,0,0,10,3,7,9,8,1,0,83.03571428571429,48.214285714285715,34.82142857142857,0,0,8.928571428571429,2.6785714285714284,6.25,8.035714285714286,7.142857142857142,0.8928571428571428,0
W00008005,132,95,58,37,0,0,24,3,21,13,10,3,0,71.96969696969697,43.93939393939394,28.030303030303028,0,0,18.181818181818183,2.272727272727273,15.909090909090908,9.848484848484848,7.575757575757576,2.272727272727273,0
W00008006,122,83,37,46,1,1,33,7,26,5,4,1,0,68.0327868852459,30.327868852459016,37.704918032786885,0.819672131147541,0.819672131147541,27.049180327868854,5.737704918032787,21.311475409836063,4.098360655737705,3.278688524590164,0.819672131147541,0
W00008007,146,99,49,50,0,0,32,18,14,15,12,3,0,67.8082191780822,33.56164383561644,34.24657534246575,0,0,21.91780821917808,12.32876712328767,9.58904109589041,10.273972602739725,8.21917808219178,2.054794520547945,0
W00008008,119,83,56,27,1,1,24,5,19,11,8,3,0,69.74789915966386,47.05882352941176,22.689075630252102,0.8403361344537815,0.8403361344537815,20.168067226890756,4.201680672268908,15.966386554621847,9.243697478991598,6.722689075630252,2.5210084033613445,0
W00008009,119,66,39,27,1,1,40,11,29,12,9,3,0,55.46218487394958,32.773109243697476,22.689075630252102,0.8403361344537815,0.8403361344537815,33.61344537815126,9.243697478991598,24.369747899159663,10.084033613445378,7.563025210084033,2.5210084033613445,0
W00008011,147,132,80,52,0,0,1,0,1,14,11,3,0,89.79591836734694,54.421768707483,35.374149659863946,0,0,0.6802721088435374,0,0.6802721088435374,9.523809523809524,7.482993197278912,2.0408163265306123,0
W00008012,163,155,66,89,0,0,0,0,0,8,8,0,0,95.0920245398773,40.49079754601227,54.601226993865026,0,0,0,0,0,4.9079754601226995,4.9079754601226995,0,0
W00008013,132,118,56,62,0,0,2,0,2,12,9,3,0,89.39393939393939,42.42424242424242,46.96969696969697,0,0,1.5151515151515151,0,1.5151515151515151,9.090909090909092,6.8181818181818175,2.272727272727273,0
W00008014,65,44,30,14,0,0,7,3,4,14,10,4,0,67.6923076923077,46.15384615384615,21.53846153846154,0,0,10.76923076923077,4.615384615384616,6.153846153846154,21.53846153846154,15.384615384615385,6.153846153846154,0
W00008015,77,37,21,16,0,0,32,13,19,8,8,0,0,48.05194805194805,27.27272727272727,20.77922077922078,0,0,41.55844155844156,16.883116883116884,24.675324675324674,10.38961038961039,10.38961038961039,0,0
W00008016,53,45,28,17,0,0,1,1,0,7,1,6,0,84.90566037735849,52.83018867924528,32.075471698113205,0,0,1.8867924528301887,1.8867924528301887,0,13.20754716981132,1.8867924528301887,11.320754716981133,0
W00008017,132,93,53,40,3,3,24,5,19,12,10,2,0,70.45454545454545,40.15151515151515,30.303030303030305,2.272727272727273,2.272727272727273,18.181818181818183,3.787878787878788,14.393939393939394,9.090909090909092,7.575757575757576,1.5151515151515151,0
W00008018,117,61,37,24,0,0,39,18,21,17,16,1,0,52.13675213675214,31.62393162393162,20.51282051282051,0,0,33.33333333333333,15.384615384615385,17.94871794871795,14.529914529914532,13.675213675213676,0.8547008547008548,0
W00008019,109,37,19,18,0,0,55,24,31,17,17,0,0,33.94495412844037,17.431192660550458,16.51376146788991,0,0,50.45871559633027,22.018348623853214,28.440366972477065,15.59633027522936,15.59633027522936,0,0
W00008020,124,75,38,37,0,0,31,12,19,18,13,5,0,60.483870967741936,30.64516129032258,29.838709677419356,0,0,25,9.67741935483871,15.32258064516129,14.516129032258066,10.483870967741936,4.032258064516129,0
W00008021,138,121,77,44,0,0,2,0,2,15,13,2,0,87.68115942028986,55.79710144927537,31.88405797101449,0,0,1.4492753623188406,0,1.4492753623188406,10.869565217391305,9.420289855072465,1.4492753623188406,0
W00008022,126,112,80,32,0,0,0,0,0,14,11,3,0,88.88888888888889,63.49206349206349,25.396825396825395,0,0,0,0,0,11.11111111111111,8.73015873015873,2.380952380952381,0
W00008023,124,66,28,38,0,0,41,13,28,17,17,0,0,53.2258064516129,22.58064516129032,30.64516129032258,0,0,33.064516129032256,10.483870967741936,22.58064516129032,13.709677419354838,13.709677419354838,0,0
W00008024,113,62,34,28,0,0,38,16,22,13,10,3,0,54.86725663716814,30.08849557522124,24.778761061946902,0,0,33.6283185840708,14.15929203539823,19.469026548672566,11.504424778761061,8.849557522123893,2.6548672566371683,0
W00008025,117,85,43,42,0,0,23,6,17,9,8,1,0,72.64957264957265,36.75213675213676,35.8974358974359,0,0,19.65811965811966,5.128205128205128,14.529914529914532,7.6923076923076925,6.837606837606838,0.8547008547008548,0
W00008026,112,56,14,42,0,0,43,13,30,13,10,3,0,50,12.5,37.5,0,0,38.392857142857146,11.607142857142858,26.785714285714285,11.607142857142858,8.928571428571429,2.6785714285714284,0
W00008027,109,45,31,14,0,0,56,18,38,8,7,1,0,41.284403669724774,28.440366972477065,12.844036697247708,0,0,51.37614678899083,16.51376146788991,34.862385321100916,7.339449541284404,6.422018348623854,0.9174311926605505,0
W00008028,127,75,38,37,0,0,26,15,11,26,25,1,0,59.055118110236215,29.92125984251969,29.133858267716533,0,0,20.47244094488189,11.811023622047244,8.661417322834646,20.47244094488189,19.68503937007874,0.7874015748031495,0
W00008029,146,65,30,35,0,0,62,28,34,19,17,2,0,44.52054794520548,20.54794520547945,23.972602739726025,0,0,42.465753424657535,19.17808219178082,23.28767123287671,13.013698630136986,11.643835616438356,1.36986301369863,0
W00008030,104,29,10,19,0,0,63,24,39,11,8,3,1,27.884615384615387,9.615384615384617,18.269230769230766,0,0,60.57692307692307,23.076923076923077,37.5,10.576923076923077,7.6923076923076925,2.8846153846153846,0.9615384615384616
W00008031,119,72,45,27,0,0,33,15,18,14,12,2,0,60.50420168067227,37.81512605042017,22.689075630252102,0,0,27.73109243697479,12.605042016806722,15.126050420168067,11.76470588235294,10.084033613445378,1.680672268907563,0
W00008032,132,33,16,17,0,0,94,16,78,5,5,0,0,25,12.121212121212121,12.878787878787879,0,0,71.21212121212122,12.121212121212121,59.09090909090909,3.787878787878788,3.787878787878788,0,0
W00008033,122,37,19,18,0,0,72,23,49,13,13,0,0,30.327868852459016,15.573770491803279,14.754098360655737,0,0,59.01639344262295,18.852459016393443,40.16393442622951,10.655737704918032,10.655737704918032,0,0
W00008034,110,51,27,24,0,0,55,21,34,4,4,0,0,46.36363636363636,24.545454545454547,21.818181818181817,0,0,50,19.090909090909093,30.909090909090907,3.6363636363636362,3.6363636363636362,0,0
W00008035,122,95,59,36,19,19,2,1,1,6,5,1,0,77.8688524590164,48.36065573770492,29.508196721311474,15.573770491803279,15.573770491803279,1.639344262295082,0.819672131147541,0.819672131147541,4.918032786885246,4.098360655737705,0.819672131147541,0
W00008036,157,139,85,54,0,0,8,4,4,10,6,4,0,88.53503184713377,54.14012738853503,34.394904458598724,0,0,5.095541401273886,2.547770700636943,2.547770700636943,6.369426751592357,3.821656050955414,2.547770700636943,0
W00008037,132,50,26,24,0,0,72,18,54,10,5,5,0,37.878787878787875,19.696969696969695,18.181818181818183,0,0,54.54545454545454,13.636363636363635,40.909090909090914,7.575757575757576,3.787878787878788,3.787878787878788,0
W00008038,111,88,46,42,0,0,7,3,4,16,15,1,0,79.27927927927928,41.44144144144144,37.83783783783784,0,0,6.306306306306306,2.7027027027027026,3.6036036036036037,14.414414414414415,13.513513513513514,0.9009009009009009,0
W00008039,71,58,28,30,0,0,3,0,3,10,6,4,0,81.69014084507043,39.436619718309856,42.25352112676056,0,0,4.225352112676056,0,4.225352112676056,14.084507042253522,8.450704225352112,5.633802816901409,0
W00008040,180,115,57,58,0,0,38,3,35,27,23,4,0,63.888888888888886,31.666666666666664,32.22222222222222,0,0,21.11111111111111,1.6666666666666667,19.444444444444446,15,12.777777777777777,2.2222222222222223,0
W00008041,123,84,42,42,0,0,18,5,13,21,19,2,0,68.29268292682927,34.146341463414636,34.146341463414636,0,0,14.634146341463413,4.0650406504065035,10.569105691056912,17.073170731707318,15.447154471544716,1.6260162601626018,0
W00008042,126,106,52,54,0,0,0,0,0,20,15,5,0,84.12698412698413,41.269841269841265,42.857142857142854,0,0,0,0,0,15.873015873015872,11.904761904761903,3.968253968253968,0
W00008043,132,100,47,53,1,1,10,3,7,21,17,4,0,75.75757575757575,35.60606060606061,40.15151515151515,0.7575757575757576,0.7575757575757576,7.575757575757576,2.272727272727273,5.303030303030303,15.909090909090908,12.878787878787879,3.0303030303030303,0
W00009797,70,68,30,38,0,0,2,0,2,0,0,0,0,97.14285714285714,42.857142857142854,54.285714285714285,0,0,2.857142857142857,0,2.857142857142857,0,0,0,0
W00009798,117,46,37,9,0,0,56,5,51,15,14,1,0,39.31623931623932,31.62393162393162,7.6923076923076925,0,0,47.863247863247864,4.273504273504273,43.58974358974359,12.82051282051282,11.965811965811966,0.8547008547008548,0
W00009800,146,141,31,110,0,0,0,0,0,5,4,1,0,96.57534246575342,21.232876712328768,75.34246575342466,0,0,0,0,0,3.4246575342465753,2.73972602739726,0.684931506849315,0
W00009801,118,111,64,47,0,0,1,0,1,6,6,0,0,94.0677966101695,54.23728813559322,39.83050847457627,0,0,0.847457627118644,0,0.847457627118644,5.084745762711865,5.084745762711865,0,0
W00010321,111,103,30,73,0,0,0,0,0,8,8,0,0,92.7927927927928,27.027027027027028,65.76576576576578,0,0,0,0,0,7.207207207207207,7.207207207207207,0,0
W00010322,43,33,12,21,0,0,3,3,0,7,5,2,0,76.74418604651163,27.906976744186046,48.837209302325576,0,0,6.976744186046512,6.976744186046512,0,16.27906976744186,11.627906976744185,4.651162790697675,0
W00010325,105,97,18,79,0,0,2,0,2,6,5,1,0,92.38095238095238,17.142857142857142,75.23809523809524,0,0,1.9047619047619049,0,1.9047619047619049,5.714285714285714,4.761904761904762,0.9523809523809524,0
W00010326,106,59,11,48,0,0,40,5,35,7,7,0,0,55.660377358490564,10.377358490566039,45.28301886792453,0,0,37.735849056603776,4.716981132075472,33.0188679245283,6.60377358490566,6.60377358490566,0,0
W00010329,82,42,17,25,2,2,28,6,22,10,10,0,0,51.21951219512195,20.73170731707317,30.48780487804878,2.4390243902439024,2.4390243902439024,34.146341463414636,7.317073170731707,26.82926829268293,12.195121951219512,12.195121951219512,0,0
W00010330,228,195,45,150,1,1,21,7,14,11,8,3,0,85.52631578947368,19.736842105263158,65.78947368421053,0.43859649122807015,0.43859649122807015,9.210526315789473,3.070175438596491,6.140350877192982,4.824561403508771,3.508771929824561,1.3157894736842104,0
W00010331,59,42,18,24,0,0,12,4,8,5,5,0,0,71.1864406779661,30.508474576271187,40.67796610169492,0,0,20.33898305084746,6.779661016949152,13.559322033898304,8.47457627118644,8.47457627118644,0,0
W00010332,185,158,59,99,6,6,9,2,7,12,11,1,0,85.4054054054054,31.891891891891895,53.51351351351351,3.2432432432432434,3.2432432432432434,4.864864864864865,1.0810810810810811,3.783783783783784,6.486486486486487,5.9459459459459465,0.5405405405405406,0
W00010333,107,55,30,25,0,0,37,16,21,15,15,0,0,51.4018691588785,28.037383177570092,23.364485981308412,0,0,34.57943925233645,14.953271028037381,19.626168224299064,14.018691588785046,14.018691588785046,0,0
W00010334,96,63,41,22,0,0,28,11,17,5,5,0,0,65.625,42.70833333333333,22.916666666666664,0,0,29.166666666666668,11.458333333333332,17.708333333333336,5.208333333333334,5.208333333333334,0,0
W00010338,77,68,6,62,0,0,7,0,7,2,2,0,0,88.31168831168831,7.792207792207792,80.51948051948052,0,0,9.090909090909092,0,9.090909090909092,2.5974025974025974,2.5974025974025974,0,0
W00010341,185,141,18,123,2,2,35,10,25,7,5,2,0,76.21621621621621,9.72972972972973,66.48648648648648,1.0810810810810811,1.0810810810810811,18.91891891891892,5.405405405405405,13.513513513513514,3.783783783783784,2.7027027027027026,1.0810810810810811,0
W00010343,229,221,100,121,0,0,4,0,4,4,3,1,0,96.50655021834062,43.66812227074236,52.838427947598255,0,0,1.7467248908296942,0,1.7467248908296942,1.7467248908296942,1.3100436681222707,0.43668122270742354,0
W00010345,76,55,16,39,0,0,16,2,14,5,1,4,0,72.36842105263158,21.052631578947366,51.31578947368421,0,0,21.052631578947366,2.631578947368421,18.421052631578945,6.578947368421052,1.3157894736842104,5.263157894736842,0
W00010346,59,41,27,14,0,0,9,2,7,9,6,3,0,69.49152542372882,45.76271186440678,23.728813559322035,0,0,15.254237288135593,3.389830508474576,11.864406779661017,15.254237288135593,10.16949152542373,5.084745762711865,0
W00010347,134,113,62,51,0,0,6,2,4,15,12,3,0,84.32835820895522,46.26865671641791,38.059701492537314,0,0,4.477611940298507,1.4925373134328357,2.9850746268656714,11.194029850746269,8.955223880597014,2.2388059701492535,0
W00010351,169,156,15,141,0,0,13,0,13,0,0,0,0,92.3076923076923,8.875739644970414,83.4319526627219,0,0,7.6923076923076925,0,7.6923076923076925,0,0,0,0
W00010354,128,111,28,83,0,0,1,0,1,16,16,0,0,86.71875,21.875,64.84375,0,0,0.78125,0,0.78125,12.5,12.5,0,0
