OA,ts0080001,ts0080002,ts0080003,ts0080002_PCT,ts0080003_PCT
E00065212,235,124,111,52.76595744680851,47.23404255319149
E00065213,357,185,172,51.820728291316534,48.17927170868347
E00065214,142,71,71,50,50
E00065215,292,149,143,51.02739726027398,48.97260273972603
E00065216,242,125,117,51.652892561983464,48.34710743801653
E00065218,276,151,125,54.710144927536234,45.289855072463766
E00065235,484,249,235,51.446280991735534,48.553719008264466
E00065236,272,144,128,52.94117647058824,47.05882352941176
E00065239,172,87,85,50.58139534883721,49.41860465116279
E00065242,285,139,146,48.771929824561404,51.2280701754386
E00065257,319,160,159,50.15673981191222,49.843260188087775
E00065269,286,148,138,51.74825174825175,48.25174825174825
E00065271,242,129,113,53.30578512396694,46.69421487603306
E00065273,204,110,94,53.92156862745098,46.07843137254902
E00175363,290,151,139,52.06896551724138,47.93103448275862
E00175365,253,128,125,50.59288537549407,49.40711462450593
E00175369,262,140,122,53.43511450381679,46.56488549618321
E00065259,452,236,216,52.21238938053098,47.78761061946903
E00065275,181,94,87,51.93370165745856,48.06629834254144
E00065278,208,112,96,53.84615384615385,46.15384615384615
E00065282,391,194,197,49.61636828644501,50.38363171355499
E00065285,193,98,95,50.77720207253886,49.22279792746114
E00065290,148,73,75,49.32432432432432,50.67567567567568
E00065280,284,141,143,49.647887323943664,50.352112676056336
E00065283,187,99,88,52.94117647058824,47.05882352941176
E00065284,225,121,104,53.77777777777778,46.22222222222222
E00065286,245,132,113,53.87755102040816,46.12244897959184
E00065289,224,117,107,52.23214285714286,47.767857142857146
E00065292,188,104,84,55.319148936170215,44.680851063829785
E00065274,206,108,98,52.42718446601942,47.57281553398058
E00175337,236,121,115,51.271186440677965,48.728813559322035
E00175367,232,113,119,48.706896551724135,51.293103448275865
E00185507,313,180,133,57.50798722044729,42.49201277955272
E00185519,159,83,76,52.20125786163522,47.79874213836478
E00185538,329,169,160,51.3677811550152,48.632218844984806
E00065276,254,145,109,57.08661417322835,42.91338582677165
E00065287,179,86,93,48.04469273743017,51.955307262569825
E00174850,223,113,110,50.672645739910315,49.327354260089685
E00175335,254,135,119,53.14960629921261,46.8503937007874
E00175336,253,130,123,51.38339920948617,48.616600790513836
E00065228,331,177,154,53.47432024169184,46.52567975830816
E00065231,279,146,133,52.32974910394266,47.67025089605735
E00065233,318,155,163,48.742138364779876,51.257861635220124
E00065244,318,168,150,52.83018867924528,47.16981132075472
E00175340,255,117,138,45.88235294117647,54.11764705882353
E00175341,346,178,168,51.445086705202314,48.554913294797686
E00065217,254,131,123,51.574803149606296,48.4251968503937
E00065220,261,138,123,52.87356321839081,47.12643678160919
E00065227,260,131,129,50.38461538461539,49.61538461538461
E00065240,310,170,140,54.83870967741935,45.16129032258064
E00065243,269,141,128,52.41635687732342,47.58364312267658
E00065262,331,175,156,52.87009063444109,47.129909365558916
E00065266,246,137,109,55.6910569105691,44.3089430894309
E00065281,246,134,112,54.47154471544715,45.52845528455284
E00065293,202,109,93,53.960396039603964,46.03960396039604
E00065294,297,147,150,49.494949494949495,50.505050505050505
E00065249,217,118,99,54.377880184331794,45.622119815668206
E00065250,284,148,136,52.112676056338024,47.88732394366197
E00065251,268,135,133,50.373134328358205,49.62686567164179
E00065252,232,125,107,53.879310344827594,46.12068965517241
E00065253,262,133,129,50.76335877862596,49.23664122137404
E00065254,245,122,123,49.795918367346935,50.204081632653065
E00065255,375,193,182,51.46666666666667,48.53333333333333
E00065256,228,119,109,52.19298245614035,47.80701754385965
E00065260,278,153,125,55.03597122302158,44.96402877697842
E00065272,180,93,87,51.66666666666667,48.333333333333336
E00065277,189,92,97,48.67724867724868,51.32275132275132
E00065279,156,80,76,51.28205128205128,48.717948717948715
E00065288,204,112,92,54.90196078431373,45.09803921568628
E00065291,191,98,93,51.30890052356021,48.69109947643979
E00065219,298,164,134,55.033557046979865,44.966442953020135
E00065230,355,195,160,54.929577464788736,45.07042253521127
E00065237,295,150,145,50.847457627118644,49.152542372881356
E00065238,304,151,153,49.67105263157895,50.32894736842105
E00065247,195,104,91,53.333333333333336,46.666666666666664
E00065248,248,125,123,50.403225806451616,49.596774193548384
E00065221,264,142,122,53.78787878787878,46.21212121212121
E00065222,275,136,139,49.45454545454545,50.54545454545455
E00065226,225,117,108,52,48
E00065241,297,165,132,55.55555555555556,44.44444444444444
E00065245,207,123,84,59.42028985507246,40.57971014492754
E00065246,281,136,145,48.39857651245551,51.60142348754449
E00065224,263,123,140,46.7680608365019,53.2319391634981
E00065225,280,140,140,50,50
E00065229,323,175,148,54.179566563467496,45.82043343653251
E00065232,375,206,169,54.93333333333334,45.06666666666666
E00065234,408,191,217,46.81372549019608,53.18627450980392
E00065295,198,102,96,51.515151515151516,48.484848484848484
E00065306,259,137,122,52.8957528957529,47.10424710424711
E00065310,254,134,120,52.75590551181102,47.24409448818898
E00065313,272,147,125,54.04411764705882,45.955882352941174
E00065323,306,171,135,55.88235294117647,44.11764705882353
E00065341,280,129,151,46.07142857142857,53.92857142857142
E00065301,231,123,108,53.246753246753244,46.75324675324675
E00065328,351,196,155,55.84045584045584,44.15954415954416
E00065343,274,152,122,55.47445255474452,44.52554744525548
E00065344,290,142,148,48.96551724137931,51.03448275862069
E00065345,183,107,76,58.46994535519126,41.53005464480874
E00065263,257,141,116,54.86381322957199,45.13618677042802
E00065264,314,168,146,53.503184713375795,46.496815286624205
E00065265,236,121,115,51.271186440677965,48.728813559322035
E00065267,271,141,130,52.02952029520295,47.97047970479705
E00065268,143,59,84,41.25874125874126,58.74125874125874
E00065298,357,189,168,52.94117647058824,47.05882352941176
E00065331,325,165,160,50.76923076923077,49.23076923076923
E00065334,316,141,175,44.620253164556964,55.379746835443036
E00065336,429,218,211,50.815850815850816,49.184149184149184
E00065339,268,142,126,52.98507462686567,47.01492537313433
E00065297,374,175,199,46.79144385026738,53.20855614973262
E00065305,208,103,105,49.519230769230774,50.480769230769226
E00065327,291,147,144,50.51546391752577,49.48453608247423
E00065330,302,141,161,46.688741721854306,53.31125827814569
E00065332,319,163,156,51.09717868338558,48.90282131661442
E00065296,277,138,139,49.81949458483754,50.18050541516246
E00065325,306,153,153,50,50
E00065326,299,167,132,55.852842809364546,44.14715719063545
E00065329,325,151,174,46.46153846153846,53.53846153846153
E00065333,291,144,147,49.48453608247423,50.51546391752577
E00065335,264,118,146,44.696969696969695,55.3030303030303
E00065337,314,163,151,51.910828025477706,48.089171974522294
E00065338,271,123,148,45.38745387453875,54.61254612546126
E00065340,304,153,151,50.32894736842105,49.67105263157895
E00065342,274,113,161,41.24087591240876,58.75912408759124
E00065299,300,163,137,54.333333333333336,45.666666666666664
E00065307,278,147,131,52.87769784172662,47.122302158273385
E00065308,323,160,163,49.53560371517028,50.464396284829725
E00065311,281,148,133,52.66903914590747,47.330960854092524
E00065316,231,113,118,48.917748917748916,51.082251082251084
E00065300,292,128,164,43.83561643835616,56.16438356164384
E00065302,318,157,161,49.37106918238994,50.62893081761006
E00065303,224,114,110,50.89285714285714,49.107142857142854
E00065304,288,131,157,45.48611111111111,54.513888888888886
E00065315,227,105,122,46.25550660792951,53.74449339207048
E00065312,248,120,128,48.38709677419355,51.61290322580645
E00065314,274,140,134,51.09489051094891,48.9051094890511
E00065318,212,118,94,55.660377358490564,44.339622641509436
E00065321,275,143,132,52,48
E00065322,196,111,85,56.63265306122449,43.36734693877551
E00065309,273,143,130,52.38095238095239,47.61904761904761
E00065317,250,130,120,52,48
E00065319,297,163,134,54.882154882154886,45.11784511784512
E00065320,245,125,120,51.02040816326531,48.97959183673469
E00065324,250,123,127,49.2,50.8
E00065511,460,229,231,49.78260869565217,50.21739130434783
E00065538,426,208,218,48.82629107981221,51.173708920187785
E00065542,210,107,103,50.95238095238095,49.047619047619044
E00065545,317,157,160,49.52681388012618,50.473186119873816
E00065523,343,174,169,50.72886297376093,49.27113702623907
E00065524,335,184,151,54.92537313432836,45.07462686567164
E00065525,265,143,122,53.9622641509434,46.0377358490566
E00065526,128,66,62,51.5625,48.4375
E00065527,513,270,243,52.63157894736842,47.368421052631575
E00065500,274,135,139,49.27007299270073,50.72992700729927
E00065509,222,127,95,57.20720720720721,42.792792792792795
E00065510,244,121,123,49.59016393442623,50.409836065573764
E00065512,356,185,171,51.96629213483146,48.03370786516854
E00065514,314,156,158,49.681528662420384,50.318471337579616
E00065455,271,152,119,56.08856088560885,43.91143911439114
E00065462,301,153,148,50.83056478405316,49.16943521594684
E00065475,332,169,163,50.903614457831324,49.096385542168676
E00065493,284,146,138,51.40845070422535,48.59154929577465
E00065494,487,243,244,49.89733059548255,50.10266940451745
E00065452,317,158,159,49.8422712933754,50.1577287066246
E00065495,348,166,182,47.701149425287355,52.29885057471264
E00065497,166,80,86,48.19277108433735,51.80722891566265
E00065498,350,162,188,46.285714285714285,53.714285714285715
E00065499,180,98,82,54.44444444444444,45.55555555555556
E00065458,305,157,148,51.47540983606558,48.52459016393443
E00065460,362,194,168,53.591160220994475,46.408839779005525
E00065461,130,73,57,56.15384615384615,43.84615384615385
E00065476,213,119,94,55.86854460093896,44.13145539906103
E00175351,354,176,178,49.717514124293785,50.282485875706215
E00175353,414,207,207,50,50
E00065515,329,173,156,52.58358662613982,47.41641337386018
E00065516,371,195,176,52.56064690026954,47.43935309973046
E00065518,298,152,146,51.006711409395976,48.99328859060403
E00065519,286,156,130,54.54545454545454,45.45454545454545
E00065521,285,142,143,49.824561403508774,50.175438596491226
E00065544,219,109,110,49.77168949771689,50.2283105022831
E00066205,330,158,172,47.878787878787875,52.121212121212125
E00066210,313,157,156,50.159744408945684,49.84025559105431
E00066234,318,150,168,47.16981132075472,52.83018867924528
E00066245,190,98,92,51.578947368421055,48.421052631578945
E00175358,288,154,134,53.47222222222222,46.52777777777778
E00175359,268,144,124,53.73134328358209,46.26865671641791
E00065862,315,152,163,48.25396825396825,51.746031746031754
E00065900,317,154,163,48.580441640378545,51.419558359621455
E00065901,285,146,139,51.2280701754386,48.771929824561404
E00065902,396,199,197,50.252525252525245,49.74747474747475
E00065907,332,159,173,47.89156626506024,52.108433734939766
E00065861,361,175,186,48.476454293628805,51.52354570637119
E00065903,322,161,161,50,50
E00065904,312,157,155,50.32051282051282,49.67948717948718
E00065905,341,186,155,54.54545454545454,45.45454545454545
E00065906,315,163,152,51.746031746031754,48.25396825396825
E00065889,244,134,110,54.91803278688525,45.08196721311475
E00065891,329,175,154,53.191489361702125,46.808510638297875
E00065895,490,296,194,60.40816326530612,39.59183673469388
E00065896,262,149,113,56.87022900763359,43.12977099236641
E00065897,320,161,159,50.31250000000001,49.6875
E00185513,216,104,112,48.148148148148145,51.85185185185185
E00185534,567,303,264,53.43915343915344,46.56084656084656
E00065890,318,161,157,50.62893081761006,49.37106918238994
E00065892,375,196,179,52.26666666666666,47.733333333333334
E00065893,306,161,145,52.614379084967325,47.385620915032675
E00065898,277,153,124,55.23465703971119,44.765342960288805
E00065899,289,148,141,51.21107266435986,48.78892733564014
E00066198,309,162,147,52.42718446601942,47.57281553398058
E00066203,179,86,93,48.04469273743017,51.955307262569825
E00066204,415,205,210,49.39759036144578,50.602409638554214
E00066241,490,243,247,49.59183673469388,50.40816326530613
E00175338,208,103,105,49.519230769230774,50.480769230769226
E00175339,789,119,670,15.082382762991129,84.91761723700887
E00065502,303,155,148,51.15511551155115,48.84488448844885
E00065503,301,151,150,50.16611295681063,49.83388704318937
E00065540,349,172,177,49.28366762177651,50.71633237822349
E00065541,329,166,163,50.455927051671736,49.544072948328264
E00065543,246,131,115,53.2520325203252,46.7479674796748
E00065501,488,233,255,47.74590163934426,52.254098360655746
E00065513,280,134,146,47.85714285714286,52.142857142857146
E00065522,134,66,68,49.25373134328358,50.74626865671642
E00065536,417,219,198,52.51798561151079,47.482014388489205
E00065537,385,205,180,53.246753246753244,46.75324675324675
E00065504,221,115,106,52.03619909502263,47.963800904977376
E00065505,248,117,131,47.17741935483871,52.82258064516129
E00065506,481,242,239,50.311850311850314,49.68814968814969
E00065507,282,145,137,51.41843971631206,48.58156028368794
E00065508,351,174,177,49.572649572649574,50.427350427350426
E00065823,308,154,154,50,50
E00065824,239,118,121,49.37238493723849,50.627615062761514
E00065855,391,200,191,51.150895140664964,48.84910485933504
E00065856,381,196,185,51.44356955380578,48.55643044619423
E00174856,297,148,149,49.831649831649834,50.16835016835017
E00175342,624,300,324,48.07692307692308,51.92307692307693
E00065869,520,282,238,54.230769230769226,45.76923076923077
E00065870,331,167,164,50.453172205438065,49.546827794561935
E00065873,247,131,116,53.036437246963565,46.963562753036435
E00065875,367,204,163,55.5858310626703,44.4141689373297
E00065884,299,158,141,52.84280936454849,47.15719063545151
E00065865,471,246,225,52.22929936305732,47.77070063694268
E00065866,472,247,225,52.33050847457628,47.66949152542373
E00065882,389,193,196,49.61439588688946,50.38560411311054
E00065886,222,123,99,55.4054054054054,44.5945945945946
E00065888,383,201,182,52.48041775456919,47.51958224543081
E00065867,280,156,124,55.714285714285715,44.285714285714285
E00065868,485,249,236,51.340206185567006,48.65979381443299
E00065871,392,190,202,48.46938775510204,51.53061224489795
E00065874,278,141,137,50.719424460431654,49.280575539568346
E00065877,303,155,148,51.15511551155115,48.84488448844885
E00065878,391,207,184,52.94117647058824,47.05882352941176
E00065879,277,143,134,51.624548736462096,48.375451263537904
E00065880,251,107,144,42.62948207171315,57.37051792828686
E00065881,221,107,114,48.41628959276018,51.58371040723983
E00065883,444,231,213,52.02702702702703,47.97297297297297
E00065857,293,147,146,50.170648464163826,49.829351535836174
E00065858,275,134,141,48.72727272727273,51.272727272727266
E00065859,321,154,167,47.97507788161994,52.024922118380054
E00065860,316,170,146,53.79746835443038,46.20253164556962
E00065864,237,119,118,50.210970464135016,49.789029535864984
E00066199,245,126,119,51.42857142857142,48.57142857142857
E00066200,125,64,61,51.2,48.8
E00066211,106,53,53,50,50
E00066212,161,83,78,51.5527950310559,48.4472049689441
E00066233,222,111,111,50,50
E00066235,255,124,131,48.627450980392155,51.37254901960784
E00066243,133,67,66,50.37593984962406,49.62406015037594
E00066246,222,109,113,49.0990990990991,50.9009009009009
E00065863,254,131,123,51.574803149606296,48.4251968503937
E00065872,311,156,155,50.160771704180064,49.839228295819936
E00065876,237,119,118,50.210970464135016,49.789029535864984
E00065885,423,221,202,52.24586288416076,47.75413711583924
E00185476,425,242,183,56.94117647058824,43.05882352941177
E00185499,336,181,155,53.86904761904761,46.13095238095239
E00185505,340,171,169,50.294117647058826,49.705882352941174
E00185521,138,61,77,44.20289855072464,55.79710144927537
E00185524,399,204,195,51.127819548872175,48.87218045112782
E00065845,232,127,105,54.741379310344826,45.258620689655174
E00065846,266,140,126,52.63157894736842,47.368421052631575
E00065847,295,155,140,52.54237288135594,47.45762711864407
E00065849,255,147,108,57.647058823529406,42.35294117647059
E00065850,282,157,125,55.673758865248224,44.32624113475177
E00065853,273,143,130,52.38095238095239,47.61904761904761
E00065825,228,126,102,55.26315789473685,44.73684210526316
E00065843,201,100,101,49.75124378109453,50.24875621890548
E00065844,251,135,116,53.78486055776892,46.21513944223107
E00065848,296,139,157,46.95945945945946,53.04054054054054
E00065851,307,156,151,50.814332247557005,49.185667752442995
E00065852,255,130,125,50.98039215686274,49.01960784313725
E00065827,317,150,167,47.3186119873817,52.6813880126183
E00065828,300,148,152,49.333333333333336,50.66666666666667
E00065829,251,131,120,52.191235059760956,47.808764940239044
E00065830,298,159,139,53.355704697986575,46.644295302013425
E00065831,317,149,168,47.003154574132495,52.99684542586751
E00065833,180,105,75,58.333333333333336,41.66666666666667
E00065834,241,131,110,54.356846473029044,45.643153526970956
E00065835,241,125,116,51.867219917012456,48.13278008298755
E00065838,372,196,176,52.68817204301075,47.31182795698925
E00065840,287,151,136,52.613240418118465,47.386759581881535
E00065841,255,134,121,52.54901960784314,47.45098039215686
E00065854,329,141,188,42.857142857142854,57.14285714285714
E00065826,283,161,122,56.8904593639576,43.109540636042404
E00065832,369,192,177,52.03252032520326,47.96747967479675
E00065836,367,195,172,53.13351498637602,46.86648501362398
E00065837,379,197,182,51.97889182058047,48.02110817941953
E00065839,268,142,126,52.98507462686567,47.01492537313433
E00065167,354,175,179,49.43502824858757,50.56497175141242
E00065192,284,145,139,51.056338028169016,48.943661971830984
E00065193,221,109,112,49.321266968325794,50.678733031674206
E00065194,356,178,178,50,50
E00065195,269,137,132,50.92936802973978,49.07063197026022
E00065174,217,99,118,45.622119815668206,54.377880184331794
E00065180,415,207,208,49.87951807228916,50.12048192771085
E00065190,379,197,182,51.97889182058047,48.02110817941953
E00065191,141,67,74,47.5177304964539,52.4822695035461
E00185518,669,178,491,26.606875934230196,73.39312406576981
E00185564,199,100,99,50.25125628140703,49.74874371859296
E00065170,361,200,161,55.4016620498615,44.59833795013851
E00065172,369,182,187,49.32249322493225,50.67750677506775
E00065173,301,162,139,53.820598006644516,46.179401993355484
E00065175,159,81,78,50.943396226415096,49.056603773584904
E00065176,118,60,58,50.847457627118644,49.152542372881356
E00065171,320,167,153,52.1875,47.8125
E00065177,270,137,133,50.74074074074074,49.25925925925926
E00065178,270,142,128,52.59259259259259,47.40740740740741
E00065179,332,165,167,49.6987951807229,50.30120481927711
E00065182,254,127,127,50,50
E00065200,306,157,149,51.307189542483655,48.69281045751634
E00065201,300,160,140,53.333333333333336,46.666666666666664
E00065202,232,120,112,51.724137931034484,48.275862068965516
E00065203,193,92,101,47.66839378238342,52.331606217616574
E00174851,308,151,157,49.02597402597403,50.97402597402597
E00174853,356,175,181,49.157303370786515,50.84269662921348
E00065183,438,230,208,52.51141552511416,47.48858447488584
E00065184,276,130,146,47.10144927536232,52.89855072463768
E00065185,298,151,147,50.671140939597315,49.328859060402685
E00065186,311,158,153,50.80385852090033,49.19614147909968
E00065187,297,148,149,49.831649831649834,50.16835016835017
E00065188,414,207,207,50,50
E00065189,312,154,158,49.358974358974365,50.641025641025635
E00065754,283,144,139,50.8833922261484,49.11660777385159
E00065755,255,138,117,54.11764705882353,45.88235294117647
E00065762,136,59,77,43.38235294117647,56.61764705882353
E00065763,255,132,123,51.76470588235295,48.23529411764706
E00065764,387,182,205,47.02842377260982,52.97157622739018
E00065765,380,186,194,48.94736842105264,51.05263157894737
E00065743,200,100,100,50,50
E00065748,267,136,131,50.936329588014985,49.063670411985015
E00065750,111,49,62,44.14414414414414,55.85585585585585
E00065751,500,254,246,50.8,49.2
E00065752,497,240,257,48.2897384305835,51.710261569416495
E00065767,220,110,110,50,50
E00066221,241,137,104,56.84647302904564,43.15352697095436
E00066224,310,157,153,50.645161290322584,49.354838709677416
E00066225,267,141,126,52.80898876404494,47.19101123595505
E00066240,487,242,245,49.69199178644764,50.308008213552355
E00185496,541,275,266,50.83179297597042,49.16820702402958
E00185523,150,75,75,50,50
E00066207,235,119,116,50.638297872340424,49.361702127659576
E00066213,399,197,202,49.373433583959894,50.6265664160401
E00066215,346,181,165,52.312138728323696,47.687861271676304
E00066236,130,58,72,44.61538461538462,55.38461538461539
E00066237,266,133,133,50,50
E00185495,119,57,62,47.89915966386555,52.10084033613446
E00185527,357,177,180,49.57983193277311,50.42016806722689
E00185551,383,197,186,51.43603133159269,48.56396866840731
E00066217,467,243,224,52.03426124197003,47.96573875802998
E00066220,392,203,189,51.78571428571429,48.214285714285715
E00066227,477,226,251,47.37945492662474,52.620545073375254
E00185502,339,164,175,48.37758112094395,51.62241887905604
E00185529,154,79,75,51.298701298701296,48.701298701298704
E00185548,276,137,139,49.63768115942029,50.36231884057971
E00066218,329,177,152,53.799392097264445,46.20060790273556
E00066219,281,154,127,54.804270462633454,45.195729537366546
E00066223,332,171,161,51.50602409638554,48.493975903614455
E00066226,365,207,158,56.71232876712329,43.28767123287671
E00066228,421,234,187,55.58194774346793,44.418052256532064
E00066229,226,120,106,53.09734513274337,46.902654867256636
E00066230,287,141,146,49.12891986062718,50.87108013937283
E00065910,326,170,156,52.14723926380368,47.85276073619632
E00065922,354,198,156,55.932203389830505,44.06779661016949
E00065923,348,185,163,53.16091954022989,46.839080459770116
E00065924,332,173,159,52.108433734939766,47.89156626506024
E00065927,268,136,132,50.74626865671642,49.25373134328358
E00065944,290,135,155,46.55172413793103,53.44827586206896
E00065945,268,142,126,52.98507462686567,47.01492537313433
E00065946,271,145,126,53.50553505535055,46.494464944649444
E00065948,218,122,96,55.96330275229357,44.03669724770643
E00065949,262,135,127,51.526717557251914,48.473282442748086
E00065913,391,210,181,53.70843989769821,46.29156010230179
E00065917,296,153,143,51.689189189189186,48.310810810810814
E00065918,282,145,137,51.41843971631206,48.58156028368794
E00065919,274,148,126,54.01459854014598,45.98540145985402
E00065925,320,167,153,52.1875,47.8125
E00065908,261,130,131,49.808429118773944,50.191570881226056
E00065911,233,125,108,53.648068669527895,46.3519313304721
E00065912,274,143,131,52.18978102189781,47.81021897810219
E00065926,392,198,194,50.51020408163265,49.48979591836735
E00065928,460,228,232,49.56521739130435,50.43478260869565
E00065914,189,102,87,53.96825396825397,46.03174603174603
E00065916,323,172,151,53.25077399380805,46.749226006191954
E00065921,360,188,172,52.22222222222223,47.77777777777778
E00185469,364,200,164,54.94505494505495,45.05494505494506
E00185475,297,155,142,52.18855218855219,47.81144781144781
E00185492,280,147,133,52.5,47.5
E00185535,352,195,157,55.39772727272727,44.60227272727273
E00185560,126,66,60,52.38095238095239,47.61904761904761
E00065920,276,151,125,54.710144927536234,45.289855072463766
E00065932,264,132,132,50,50
E00065934,283,143,140,50.53003533568905,49.46996466431096
E00065936,307,166,141,54.071661237785015,45.928338762214985
E00065956,308,154,154,50,50
E00065793,257,127,130,49.416342412451364,50.583657587548636
E00065796,292,149,143,51.02739726027398,48.97260273972603
E00065800,278,152,126,54.67625899280576,45.32374100719424
E00065819,318,163,155,51.257861635220124,48.742138364779876
E00065820,319,160,159,50.15673981191222,49.843260188087775
E00065797,320,162,158,50.625,49.375
E00065817,269,151,118,56.13382899628253,43.866171003717476
E00065818,277,144,133,51.985559566786996,48.014440433213
E00065821,296,168,128,56.75675675675676,43.24324324324324
E00065822,376,176,200,46.808510638297875,53.191489361702125
E00065947,238,122,116,51.26050420168067,48.739495798319325
E00065950,259,141,118,54.440154440154444,45.559845559845556
E00065951,285,142,143,49.824561403508774,50.175438596491226
E00065952,231,127,104,54.97835497835498,45.02164502164502
E00065953,288,146,142,50.69444444444444,49.30555555555556
E00065954,229,119,110,51.96506550218341,48.03493449781659
E00065930,325,182,143,56.00000000000001,44
E00065933,230,131,99,56.95652173913044,43.04347826086957
E00065955,282,157,125,55.673758865248224,44.32624113475177
E00065957,240,124,116,51.66666666666667,48.333333333333336
E00065959,174,79,95,45.40229885057471,54.59770114942529
E00065960,258,129,129,50,50
E00065677,272,140,132,51.470588235294116,48.529411764705884
E00065678,294,150,144,51.02040816326531,48.97959183673469
E00065679,409,219,190,53.54523227383863,46.454767726161364
E00065680,350,180,170,51.42857142857142,48.57142857142857
E00065684,386,198,188,51.29533678756477,48.704663212435236
E00065719,269,133,136,49.44237918215613,50.55762081784386
E00065685,332,163,169,49.096385542168676,50.903614457831324
E00065698,296,151,145,51.01351351351351,48.986486486486484
E00065701,311,157,154,50.482315112540185,49.51768488745981
E00065703,317,167,150,52.6813880126183,47.3186119873817
E00065704,404,201,203,49.75247524752475,50.24752475247525
E00065718,162,75,87,46.2962962962963,53.70370370370371
E00065696,351,181,170,51.566951566951566,48.433048433048434
E00065697,434,234,200,53.91705069124424,46.08294930875576
E00065699,281,150,131,53.380782918149464,46.619217081850536
E00065700,331,159,172,48.036253776435046,51.963746223564954
E00065702,444,225,219,50.67567567567568,49.32432432432432
E00066197,258,128,130,49.6124031007752,50.3875968992248
E00066202,296,150,146,50.67567567567568,49.32432432432432
E00066208,152,76,76,50,50
E00066209,203,105,98,51.724137931034484,48.275862068965516
E00066238,331,162,169,48.94259818731118,51.057401812688816
E00066239,219,103,116,47.03196347031963,52.96803652968036
E00066196,230,120,110,52.17391304347826,47.82608695652174
E00066201,356,180,176,50.56179775280899,49.43820224719101
E00066231,517,259,258,50.09671179883946,49.90328820116054
E00066232,347,164,183,47.262247838616716,52.73775216138329
E00066242,142,75,67,52.816901408450704,47.183098591549296
E00065794,255,145,110,56.86274509803921,43.13725490196079
E00065795,219,119,100,54.337899543378995,45.662100456621005
E00065798,234,123,111,52.56410256410257,47.43589743589743
E00065801,206,108,98,52.42718446601942,47.57281553398058
E00065808,264,137,127,51.89393939393939,48.10606060606061
E00065809,232,133,99,57.327586206896555,42.672413793103445
E00065791,277,144,133,51.985559566786996,48.014440433213
E00065799,265,133,132,50.18867924528302,49.81132075471698
E00065802,294,148,146,50.34013605442177,49.65986394557823
E00065803,247,122,125,49.392712550607285,50.607287449392715
E00065804,295,155,140,52.54237288135594,47.45762711864407
E00065769,451,253,198,56.09756097560976,43.90243902439025
E00065806,274,158,116,57.66423357664233,42.33576642335766
E00065813,351,169,182,48.148148148148145,51.85185185185185
E00174854,263,134,129,50.950570342205324,49.049429657794676
E00175334,318,165,153,51.886792452830186,48.113207547169814
E00175368,183,100,83,54.644808743169406,45.3551912568306
E00185517,269,138,131,51.301115241635685,48.698884758364315
E00185525,221,106,115,47.963800904977376,52.03619909502263
E00065790,107,58,49,54.20560747663551,45.794392523364486
E00065792,186,116,70,62.365591397849464,37.634408602150536
E00065807,436,236,200,54.12844036697248,45.87155963302752
E00065810,210,113,97,53.80952380952381,46.19047619047619
E00065811,193,88,105,45.59585492227979,54.40414507772021
E00065814,187,101,86,54.01069518716578,45.98930481283423
E00065815,241,130,111,53.941908713692946,46.058091286307054
E00065931,249,137,112,55.020080321285135,44.97991967871486
E00065935,358,193,165,53.910614525139664,46.089385474860336
E00065937,193,86,107,44.559585492227974,55.44041450777202
E00065938,294,152,142,51.70068027210885,48.29931972789115
E00065939,239,130,109,54.39330543933054,45.60669456066946
E00065940,247,136,111,55.06072874493927,44.93927125506073
E00065929,269,139,130,51.6728624535316,48.3271375464684
E00065941,252,127,125,50.39682539682539,49.60317460317461
E00065942,279,143,136,51.25448028673835,48.74551971326165
E00065943,275,141,134,51.272727272727266,48.72727272727273
E00065958,407,217,190,53.31695331695332,46.68304668304668
E00065168,437,244,193,55.83524027459954,44.16475972540046
E00065169,224,118,106,52.67857142857143,47.32142857142857
E00065208,273,143,130,52.38095238095239,47.61904761904761
E00065209,290,164,126,56.55172413793104,43.44827586206896
E00065210,234,119,115,50.85470085470085,49.14529914529914
E00065204,285,138,147,48.421052631578945,51.578947368421055
E00065205,268,135,133,50.373134328358205,49.62686567164179
E00065206,297,150,147,50.505050505050505,49.494949494949495
E00065207,291,152,139,52.23367697594502,47.766323024054984
E00065768,186,91,95,48.924731182795696,51.075268817204304
E00065771,242,128,114,52.892561983471076,47.107438016528924
E00065775,247,128,119,51.821862348178136,48.178137651821864
E00065780,485,233,252,48.04123711340206,51.958762886597945
E00065782,204,100,104,49.01960784313725,50.98039215686274
E00065788,263,130,133,49.42965779467681,50.57034220532319
E00065789,306,163,143,53.26797385620915,46.73202614379085
E00065770,252,126,126,50,50
E00065772,220,114,106,51.81818181818182,48.18181818181818
E00065773,470,244,226,51.91489361702127,48.08510638297872
E00065776,251,117,134,46.613545816733065,53.38645418326693
E00065816,320,171,149,53.43750000000001,46.5625
E00065774,340,190,150,55.88235294117647,44.11764705882353
E00065779,223,112,111,50.224215246636774,49.775784753363226
E00065784,305,158,147,51.80327868852459,48.19672131147541
E00185466,415,216,199,52.04819277108433,47.95180722891566
E00065781,549,273,276,49.72677595628415,50.27322404371585
E00065783,362,174,188,48.06629834254144,51.93370165745856
E00065785,273,148,125,54.21245421245421,45.78754578754579
E00065786,574,297,277,51.742160278745644,48.257839721254356
E00065787,195,98,97,50.256410256410255,49.743589743589745
E00065720,356,185,171,51.96629213483146,48.03370786516854
E00065721,335,167,168,49.850746268656714,50.14925373134328
E00065722,312,161,151,51.60256410256411,48.3974358974359
E00065723,276,142,134,51.449275362318836,48.55072463768116
E00065745,191,104,87,54.45026178010471,45.54973821989529
E00065739,115,55,60,47.82608695652174,52.17391304347826
E00065749,213,98,115,46.009389671361504,53.990610328638496
E00065758,279,151,128,54.121863799283155,45.878136200716845
E00065759,292,144,148,49.31506849315068,50.68493150684932
E00065761,282,148,134,52.4822695035461,47.5177304964539
E00065766,219,111,108,50.68493150684932,49.31506849315068
E00065724,274,131,143,47.81021897810219,52.18978102189781
E00065726,228,118,110,51.75438596491229,48.24561403508772
E00065728,295,153,142,51.864406779661024,48.13559322033898
E00065730,235,121,114,51.48936170212765,48.51063829787234
E00065760,357,192,165,53.78151260504202,46.21848739495798
E00065725,218,115,103,52.752293577981646,47.24770642201835
E00065727,220,109,111,49.54545454545455,50.45454545454545
E00065729,286,152,134,53.14685314685315,46.85314685314685
E00065731,134,67,67,50,50
E00065732,229,114,115,49.78165938864629,50.21834061135371
E00065744,322,159,163,49.378881987577635,50.621118012422365
E00065746,336,163,173,48.51190476190476,51.488095238095234
E00065753,526,266,260,50.57034220532319,49.42965779467681
E00065756,295,148,147,50.16949152542372,49.83050847457628
E00065757,311,160,151,51.446945337620576,48.55305466237942
E00065357,239,119,120,49.7907949790795,50.2092050209205
E00065363,275,140,135,50.90909090909091,49.09090909090909
E00065364,309,165,144,53.398058252427184,46.601941747572816
E00185473,353,193,160,54.6742209631728,45.3257790368272
E00185500,265,139,126,52.45283018867924,47.54716981132076
E00065350,308,166,142,53.896103896103895,46.103896103896105
E00065355,285,144,141,50.526315789473685,49.473684210526315
E00065359,265,136,129,51.320754716981135,48.679245283018865
E00065367,308,151,157,49.02597402597403,50.97402597402597
E00065351,251,129,122,51.39442231075697,48.60557768924303
E00065352,260,128,132,49.23076923076923,50.76923076923077
E00065356,248,134,114,54.03225806451613,45.96774193548387
E00065362,254,134,120,52.75590551181102,47.24409448818898
E00065374,351,180,171,51.28205128205128,48.717948717948715
E00065375,241,131,110,54.356846473029044,45.643153526970956
E00065378,203,109,94,53.69458128078818,46.30541871921182
E00065393,348,186,162,53.44827586206896,46.55172413793103
E00185487,614,329,285,53.583061889250814,46.416938110749186
E00185490,215,76,139,35.348837209302324,64.65116279069767
E00185497,235,130,105,55.319148936170215,44.680851063829785
E00065434,288,147,141,51.041666666666664,48.95833333333333
E00065435,251,133,118,52.98804780876494,47.01195219123506
E00065436,302,157,145,51.98675496688742,48.01324503311258
E00065437,191,99,92,51.832460732984295,48.167539267015705
E00065438,203,114,89,56.15763546798029,43.84236453201971
E00065346,312,166,146,53.205128205128204,46.794871794871796
E00065347,254,123,131,48.4251968503937,51.574803149606296
E00065348,260,125,135,48.07692307692308,51.92307692307693
E00065366,493,242,251,49.08722109533469,50.91277890466531
E00065353,470,238,232,50.638297872340424,49.361702127659576
E00065354,266,140,126,52.63157894736842,47.368421052631575
E00065365,274,121,153,44.16058394160584,55.839416058394164
E00065368,284,144,140,50.70422535211267,49.29577464788733
E00065369,309,161,148,52.103559870550164,47.896440129449836
E00065379,440,209,231,47.5,52.5
E00065388,249,136,113,54.61847389558233,45.38152610441767
E00065389,245,128,117,52.244897959183675,47.755102040816325
E00065392,313,158,155,50.47923322683706,49.52076677316294
E00065398,218,120,98,55.04587155963303,44.95412844036697
E00065384,203,120,83,59.11330049261084,40.88669950738916
E00065387,326,172,154,52.760736196319016,47.239263803680984
E00065394,245,131,114,53.46938775510204,46.53061224489796
E00065397,394,216,178,54.82233502538071,45.17766497461929
E00065373,231,113,118,48.917748917748916,51.082251082251084
E00065380,293,142,151,48.4641638225256,51.5358361774744
E00065381,324,165,159,50.92592592592593,49.074074074074076
E00065382,251,129,122,51.39442231075697,48.60557768924303
E00065383,280,139,141,49.642857142857146,50.357142857142854
E00065399,340,166,174,48.8235294117647,51.17647058823529
E00065440,360,185,175,51.388888888888886,48.61111111111111
E00065442,312,161,151,51.60256410256411,48.3974358974359
E00065445,243,123,120,50.617283950617285,49.382716049382715
E00065450,352,173,179,49.14772727272727,50.85227272727273
E00065451,288,162,126,56.25,43.75
E00065439,388,197,191,50.77319587628865,49.22680412371135
E00065446,319,174,145,54.54545454545454,45.45454545454545
E00065447,330,169,161,51.21212121212121,48.78787878787879
E00065448,263,139,124,52.851711026615966,47.14828897338403
E00065449,306,161,145,52.614379084967325,47.385620915032675
E00065406,305,157,148,51.47540983606558,48.52459016393443
E00065441,284,143,141,50.352112676056336,49.647887323943664
E00065443,268,138,130,51.49253731343284,48.507462686567166
E00175364,114,52,62,45.614035087719294,54.385964912280706
E00175366,113,55,58,48.67256637168141,51.32743362831859
E00065196,369,189,180,51.21951219512195,48.78048780487805
E00065197,418,204,214,48.803827751196174,51.196172248803826
E00065198,351,181,170,51.566951566951566,48.433048433048434
E00065211,400,209,191,52.25,47.75
E00065431,313,163,150,52.07667731629393,47.92332268370607
E00065432,311,173,138,55.62700964630225,44.37299035369775
E00065433,328,171,157,52.13414634146341,47.86585365853659
E00065349,205,112,93,54.63414634146342,45.36585365853659
E00065358,180,99,81,55.00000000000001,45
E00065361,270,141,129,52.22222222222223,47.77777777777778
E00065371,280,142,138,50.71428571428571,49.28571428571429
E00065372,219,113,106,51.598173515981735,48.401826484018265
E00185465,210,117,93,55.714285714285715,44.285714285714285
E00065385,292,162,130,55.47945205479452,44.52054794520548
E00065386,336,171,165,50.89285714285714,49.107142857142854
E00065390,270,141,129,52.22222222222223,47.77777777777778
E00065391,377,199,178,52.785145888594165,47.214854111405835
E00065395,353,187,166,52.97450424929179,47.02549575070821
E00065376,220,111,109,50.45454545454545,49.54545454545455
E00065377,231,108,123,46.75324675324675,53.246753246753244
E00065396,349,173,176,49.570200573065904,50.429799426934096
E00065401,199,103,96,51.75879396984925,48.24120603015075
E00065402,231,128,103,55.41125541125541,44.58874458874459
E00065403,191,107,84,56.02094240837696,43.97905759162304
E00066170,231,118,113,51.082251082251084,48.917748917748916
E00066172,286,157,129,54.89510489510489,45.10489510489511
E00066178,227,122,105,53.74449339207048,46.25550660792951
E00066183,337,160,177,47.47774480712167,52.52225519287834
E00066187,298,154,144,51.67785234899329,48.322147651006716
E00065686,403,211,192,52.357320099255574,47.64267990074442
E00065690,271,141,130,52.02952029520295,47.97047970479705
E00065691,314,168,146,53.503184713375795,46.496815286624205
E00065693,255,134,121,52.54901960784314,47.45098039215686
E00185549,430,216,214,50.23255813953489,49.76744186046512
E00185559,244,116,128,47.540983606557376,52.459016393442624
E00065676,304,151,153,49.67105263157895,50.32894736842105
E00065705,204,101,103,49.50980392156863,50.49019607843137
E00065708,327,162,165,49.54128440366973,50.45871559633027
E00185508,992,85,907,8.568548387096774,91.43145161290323
E00185532,135,65,70,48.148148148148145,51.85185185185185
E00065675,311,156,155,50.160771704180064,49.839228295819936
E00065687,277,141,136,50.90252707581227,49.09747292418773
E00065688,326,169,157,51.84049079754601,48.15950920245399
E00065692,262,129,133,49.23664122137404,50.76335877862596
E00065694,245,126,119,51.42857142857142,48.57142857142857
E00065713,427,210,217,49.18032786885246,50.81967213114754
E00065715,292,153,139,52.3972602739726,47.6027397260274
E00065716,390,201,189,51.53846153846153,48.46153846153846
E00065717,250,130,120,52,48
E00065695,407,212,195,52.08845208845209,47.91154791154791
E00065709,254,127,127,50,50
E00065710,363,180,183,49.586776859504134,50.413223140495866
E00065711,294,143,151,48.63945578231292,51.36054421768708
E00065712,346,165,181,47.687861271676304,52.312138728323696
E00066121,306,155,151,50.65359477124183,49.34640522875817
E00066125,271,145,126,53.50553505535055,46.494464944649444
E00066128,280,143,137,51.07142857142857,48.92857142857142
E00066133,281,151,130,53.736654804270465,46.263345195729535
E00066140,288,157,131,54.513888888888886,45.48611111111111
E00066164,417,234,183,56.11510791366906,43.884892086330936
E00066182,270,145,125,53.70370370370371,46.2962962962963
E00066184,202,108,94,53.46534653465347,46.53465346534654
E00066185,275,157,118,57.09090909090909,42.90909090909091
E00066186,349,176,173,50.429799426934096,49.570200573065904
E00066171,311,153,158,49.19614147909968,50.80385852090033
E00066188,233,106,127,45.493562231759654,54.506437768240346
E00066189,309,143,166,46.27831715210356,53.72168284789643
E00066191,296,147,149,49.66216216216216,50.33783783783784
E00066194,234,118,116,50.427350427350426,49.572649572649574
E00066173,353,179,174,50.70821529745042,49.29178470254957
E00066174,281,141,140,50.177935943060504,49.8220640569395
E00066175,301,153,148,50.83056478405316,49.16943521594684
E00066176,234,116,118,49.572649572649574,50.427350427350426
E00066195,227,125,102,55.06607929515418,44.93392070484582
E00066152,364,189,175,51.92307692307693,48.07692307692308
E00066168,270,135,135,50,50
E00066190,290,147,143,50.689655172413794,49.310344827586206
E00066192,231,115,116,49.78354978354979,50.21645021645021
E00066193,325,161,164,49.53846153846154,50.46153846153846
E00066131,289,144,145,49.82698961937716,50.17301038062284
E00066136,516,266,250,51.55038759689923,48.44961240310077
E00066142,207,112,95,54.106280193236714,45.893719806763286
E00066147,317,159,158,50.1577287066246,49.8422712933754
E00066148,291,141,150,48.45360824742268,51.546391752577314
E00066169,326,185,141,56.74846625766872,43.25153374233129
E00066177,278,146,132,52.51798561151079,47.482014388489205
E00066179,268,144,124,53.73134328358209,46.26865671641791
E00066180,288,152,136,52.77777777777778,47.22222222222222
E00066181,282,143,139,50.70921985815603,49.29078014184397
E00066151,290,153,137,52.758620689655174,47.241379310344826
E00066153,326,163,163,50,50
E00066156,302,156,146,51.65562913907284,48.34437086092716
E00066160,252,128,124,50.79365079365079,49.2063492063492
E00066162,312,150,162,48.07692307692308,51.92307692307693
E00066161,402,202,200,50.24875621890548,49.75124378109453
E00066163,506,264,242,52.17391304347826,47.82608695652174
E00066165,335,165,170,49.25373134328358,50.74626865671642
E00066166,281,147,134,52.313167259786475,47.686832740213525
E00066167,335,167,168,49.850746268656714,50.14925373134328
E00066154,348,166,182,47.701149425287355,52.29885057471264
E00066155,323,156,167,48.297213622291025,51.702786377708975
E00066157,267,139,128,52.05992509363296,47.940074906367045
E00066158,223,119,104,53.36322869955157,46.63677130044843
E00066159,307,152,155,49.5114006514658,50.4885993485342
E00066080,353,187,166,52.97450424929179,47.02549575070821
E00066083,321,161,160,50.155763239875384,49.84423676012461
E00066103,400,193,207,48.25,51.74999999999999
E00066105,333,172,161,51.651651651651655,48.348348348348345
E00066075,263,136,127,51.71102661596958,48.28897338403042
E00066081,256,133,123,51.953125,48.046875
E00066085,383,216,167,56.39686684073107,43.60313315926893
E00066086,270,147,123,54.44444444444444,45.55555555555556
E00066088,313,154,159,49.201277955271564,50.798722044728436
E00066084,304,165,139,54.276315789473685,45.723684210526315
E00066089,263,141,122,53.61216730038023,46.38783269961977
E00066098,445,222,223,49.8876404494382,50.112359550561806
E00066099,384,188,196,48.95833333333333,51.041666666666664
E00066100,411,214,197,52.06812652068127,47.93187347931874
E00066073,287,133,154,46.34146341463415,53.65853658536586
E00066076,254,125,129,49.21259842519685,50.78740157480315
E00066082,234,119,115,50.85470085470085,49.14529914529914
E00066092,215,113,102,52.55813953488372,47.44186046511628
E00066093,265,132,133,49.81132075471698,50.18867924528302
E00066097,290,151,139,52.06896551724138,47.93103448275862
E00066101,283,142,141,50.17667844522968,49.82332155477032
E00066102,335,181,154,54.02985074626866,45.97014925373134
E00066104,242,126,116,52.066115702479344,47.93388429752066
E00066106,241,123,118,51.037344398340245,48.96265560165975
E00065736,312,145,167,46.47435897435898,53.52564102564102
E00065740,302,153,149,50.66225165562914,49.337748344370866
E00065741,326,164,162,50.306748466257666,49.693251533742334
E00065742,351,193,158,54.98575498575499,45.01424501424501
E00065747,294,141,153,47.95918367346938,52.04081632653062
E00065994,236,124,112,52.54237288135594,47.45762711864407
E00066015,216,105,111,48.61111111111111,51.388888888888886
E00066016,278,135,143,48.561151079136685,51.438848920863315
E00066017,383,200,183,52.219321148825074,47.78067885117493
E00066018,325,164,161,50.46153846153846,49.53846153846154
E00065998,316,161,155,50.9493670886076,49.050632911392405
E00066000,345,179,166,51.8840579710145,48.11594202898551
E00066005,281,139,142,49.46619217081851,50.5338078291815
E00066006,349,178,171,51.00286532951289,48.99713467048711
E00066020,221,107,114,48.41628959276018,51.58371040723983
E00066014,189,91,98,48.148148148148145,51.85185185185185
E00066022,519,259,260,49.90366088631985,50.09633911368015
E00066031,371,179,192,48.24797843665768,51.75202156334232
E00066032,264,132,132,50,50
E00066040,283,143,140,50.53003533568905,49.46996466431096
E00065999,394,193,201,48.984771573604064,51.01522842639594
E00066001,360,184,176,51.11111111111111,48.888888888888886
E00066002,270,130,140,48.148148148148145,51.85185185185185
E00066003,326,159,167,48.77300613496933,51.22699386503068
E00066004,362,178,184,49.171270718232044,50.82872928176796
E00065404,151,74,77,49.00662251655629,50.993377483443716
E00065407,380,198,182,52.10526315789473,47.89473684210526
E00065408,316,172,144,54.43037974683544,45.56962025316456
E00065430,130,60,70,46.15384615384615,53.84615384615385
E00185501,408,201,207,49.26470588235294,50.73529411764706
E00185522,283,141,142,49.82332155477032,50.17667844522968
E00185542,147,73,74,49.65986394557823,50.34013605442177
E00065410,381,207,174,54.330708661417326,45.66929133858268
E00065413,247,132,115,53.441295546558706,46.558704453441294
E00065414,287,161,126,56.09756097560976,43.90243902439025
E00065424,309,161,148,52.103559870550164,47.896440129449836
E00065425,339,177,162,52.21238938053098,47.78761061946903
E00065411,274,145,129,52.919708029197075,47.08029197080292
E00065417,380,191,189,50.26315789473684,49.73684210526316
E00065418,299,155,144,51.83946488294314,48.16053511705686
E00065421,331,170,161,51.3595166163142,48.6404833836858
E00065426,272,152,120,55.88235294117647,44.11764705882353
E00066067,211,110,101,52.13270142180095,47.867298578199055
E00066068,249,126,123,50.602409638554214,49.39759036144578
E00066072,304,152,152,50,50
E00175331,462,220,242,47.61904761904761,52.38095238095239
E00175360,296,147,149,49.66216216216216,50.33783783783784
E00175361,212,104,108,49.056603773584904,50.943396226415096
E00185537,149,78,71,52.348993288590606,47.651006711409394
E00185553,197,95,102,48.223350253807105,51.776649746192895
E00185556,600,325,275,54.166666666666664,45.83333333333333
E00174859,339,164,175,48.37758112094395,51.62241887905604
E00174862,236,118,118,50,50
E00174864,300,157,143,52.33333333333333,47.66666666666667
E00174865,299,161,138,53.84615384615385,46.15384615384615
E00175347,340,166,174,48.8235294117647,51.17647058823529
E00065409,540,270,270,50,50
E00065415,181,94,87,51.93370165745856,48.06629834254144
E00065416,327,165,162,50.45871559633027,49.54128440366973
E00065419,248,120,128,48.38709677419355,51.61290322580645
E00174861,276,137,139,49.63768115942029,50.36231884057971
E00065405,203,100,103,49.26108374384236,50.73891625615764
E00065422,270,141,129,52.22222222222223,47.77777777777778
E00065427,259,135,124,52.123552123552116,47.87644787644788
E00065428,277,135,142,48.73646209386281,51.26353790613718
E00175330,204,98,106,48.03921568627451,51.9607843137255
E00065429,243,111,132,45.67901234567901,54.32098765432099
E00175343,311,160,151,51.446945337620576,48.55305466237942
E00175344,203,103,100,50.73891625615764,49.26108374384236
E00175345,443,221,222,49.887133182844245,50.112866817155755
E00175346,420,198,222,47.14285714285714,52.85714285714286
E00065733,311,151,160,48.55305466237942,51.446945337620576
E00065734,247,128,119,51.821862348178136,48.178137651821864
E00065735,395,219,176,55.44303797468354,44.55696202531645
E00065737,291,146,145,50.171821305841924,49.828178694158076
E00065738,303,142,161,46.864686468646866,53.135313531353134
E00066077,243,119,124,48.971193415637856,51.028806584362144
E00066078,335,167,168,49.850746268656714,50.14925373134328
E00066087,269,136,133,50.55762081784386,49.44237918215613
E00066091,262,128,134,48.854961832061065,51.14503816793893
E00174857,347,196,151,56.48414985590778,43.51585014409222
E00175354,351,177,174,50.427350427350426,49.572649572649574
E00175362,407,191,216,46.928746928746925,53.07125307125307
E00066074,263,142,121,53.99239543726235,46.00760456273764
E00066090,423,241,182,56.973995271867615,43.02600472813239
E00066094,244,130,114,53.278688524590166,46.72131147540984
E00066095,243,115,128,47.325102880658434,52.674897119341566
E00066096,255,121,134,47.45098039215686,52.54901960784314
E00066107,333,164,169,49.249249249249246,50.750750750750754
E00066108,310,158,152,50.967741935483865,49.03225806451613
E00066110,433,224,209,51.73210161662818,48.26789838337183
E00066114,274,137,137,50,50
E00066115,294,150,144,51.02040816326531,48.97959183673469
E00066109,302,153,149,50.66225165562914,49.337748344370866
E00066111,308,160,148,51.94805194805194,48.05194805194805
E00066112,447,232,215,51.90156599552572,48.09843400447427
E00066113,273,134,139,49.08424908424908,50.91575091575091
E00066116,275,141,134,51.272727272727266,48.72727272727273
E00065648,292,149,143,51.02739726027398,48.97260273972603
E00065649,305,153,152,50.1639344262295,49.8360655737705
E00065650,259,138,121,53.28185328185329,46.71814671814672
E00065651,242,124,118,51.2396694214876,48.760330578512395
E00065658,288,147,141,51.041666666666664,48.95833333333333
E00065613,268,132,136,49.25373134328358,50.74626865671642
E00065653,239,118,121,49.37238493723849,50.627615062761514
E00065654,146,69,77,47.26027397260274,52.73972602739726
E00065655,294,158,136,53.74149659863946,46.25850340136054
E00065657,320,174,146,54.37499999999999,45.625
E00065659,293,140,153,47.781569965870304,52.218430034129696
E00065616,256,126,130,49.21875,50.78125
E00065618,275,136,139,49.45454545454545,50.54545454545455
E00065621,308,170,138,55.1948051948052,44.8051948051948
E00065624,292,158,134,54.109589041095894,45.89041095890411
E00065627,306,150,156,49.01960784313725,50.98039215686274
E00065611,185,94,91,50.810810810810814,49.18918918918919
E00065625,314,145,169,46.17834394904459,53.82165605095541
E00065634,321,162,159,50.467289719626166,49.532710280373834
E00065638,303,150,153,49.504950495049506,50.495049504950494
E00065639,271,139,132,51.291512915129154,48.708487084870846
E00066118,216,116,100,53.70370370370371,46.2962962962963
E00066138,321,156,165,48.598130841121495,51.4018691588785
E00066139,176,101,75,57.38636363636363,42.61363636363637
E00066144,292,138,154,47.26027397260274,52.73972602739726
E00066150,593,326,267,54.97470489038786,45.02529510961214
E00185483,389,196,193,50.38560411311054,49.61439588688946
E00185547,184,111,73,60.32608695652174,39.67391304347826
E00066046,285,138,147,48.421052631578945,51.578947368421055
E00066053,367,191,176,52.043596730245234,47.956403269754766
E00066054,343,179,164,52.1865889212828,47.8134110787172
E00066061,460,230,230,50,50
E00066066,382,190,192,49.73821989528796,50.26178010471204
E00066043,372,201,171,54.03225806451613,45.96774193548387
E00066044,323,164,159,50.77399380804953,49.22600619195047
E00066045,375,185,190,49.333333333333336,50.66666666666667
E00066050,262,146,116,55.72519083969466,44.274809160305345
E00066051,338,174,164,51.4792899408284,48.5207100591716
E00066047,297,157,140,52.861952861952865,47.13804713804714
E00066048,273,139,134,50.91575091575091,49.08424908424908
E00066049,365,190,175,52.054794520547944,47.94520547945205
E00066052,364,188,176,51.64835164835166,48.35164835164835
E00066071,152,65,87,42.76315789473684,57.23684210526315
E00066056,276,142,134,51.449275362318836,48.55072463768116
E00066062,371,184,187,49.59568733153639,50.40431266846361
E00066063,262,127,135,48.473282442748086,51.526717557251914
E00066064,321,156,165,48.598130841121495,51.4018691588785
E00066065,280,150,130,53.57142857142857,46.42857142857143
E00066055,366,180,186,49.18032786885246,50.81967213114754
E00066057,293,146,147,49.829351535836174,50.170648464163826
E00066058,283,138,145,48.76325088339223,51.23674911660777
E00066059,331,174,157,52.567975830815705,47.43202416918429
E00066060,336,185,151,55.05952380952381,44.94047619047619
E00065612,318,174,144,54.71698113207547,45.28301886792453
E00065637,293,148,145,50.51194539249146,49.48805460750853
E00065656,333,165,168,49.549549549549546,50.45045045045045
E00185474,282,149,133,52.836879432624116,47.16312056737589
E00185481,511,268,243,52.44618395303326,47.55381604696673
E00185528,229,119,110,51.96506550218341,48.03493449781659
E00065636,297,158,139,53.198653198653204,46.801346801346796
E00065641,283,138,145,48.76325088339223,51.23674911660777
E00065644,285,151,134,52.98245614035088,47.01754385964912
E00065645,288,143,145,49.65277777777778,50.34722222222222
E00065646,332,181,151,54.51807228915663,45.48192771084337
E00065628,312,157,155,50.32051282051282,49.67948717948718
E00065629,369,184,185,49.86449864498645,50.135501355013545
E00065631,294,163,131,55.44217687074829,44.5578231292517
E00065632,276,153,123,55.434782608695656,44.565217391304344
E00065643,267,151,116,56.55430711610487,43.445692883895134
E00065619,604,303,301,50.16556291390728,49.83443708609271
E00065620,432,228,204,52.77777777777778,47.22222222222222
E00065633,267,136,131,50.936329588014985,49.063670411985015
E00065640,488,276,212,56.557377049180324,43.44262295081967
E00065551,273,137,136,50.18315018315018,49.81684981684982
E00065575,318,169,149,53.144654088050316,46.855345911949684
E00065576,278,140,138,50.35971223021583,49.64028776978417
E00065577,377,193,184,51.19363395225464,48.80636604774536
E00065578,504,267,237,52.976190476190474,47.023809523809526
E00065546,249,133,116,53.41365461847389,46.58634538152611
E00065547,581,284,297,48.88123924268503,51.11876075731497
E00065550,592,296,296,50,50
E00065555,594,306,288,51.515151515151516,48.484848484848484
E00065560,272,136,136,50,50
E00065664,334,162,172,48.50299401197605,51.49700598802395
E00065666,325,158,167,48.61538461538461,51.38461538461539
E00065668,399,201,198,50.37593984962406,49.62406015037594
E00065669,282,147,135,52.12765957446809,47.87234042553192
E00065670,415,196,219,47.2289156626506,52.77108433734939
E00065660,367,175,192,47.68392370572207,52.31607629427793
E00065661,433,214,219,49.42263279445728,50.57736720554272
E00065662,254,118,136,46.45669291338583,53.54330708661418
E00065671,343,159,184,46.35568513119534,53.64431486880466
E00065674,388,207,181,53.350515463917525,46.649484536082475
E00065579,222,110,112,49.549549549549546,50.45045045045045
E00065599,274,153,121,55.839416058394164,44.16058394160584
E00065601,368,192,176,52.17391304347826,47.82608695652174
E00065603,276,143,133,51.81159420289855,48.188405797101446
E00065607,297,147,150,49.494949494949495,50.505050505050505
E00065663,286,140,146,48.95104895104895,51.048951048951054
E00065665,313,147,166,46.96485623003195,53.03514376996805
E00065672,328,171,157,52.13414634146341,47.86585365853659
E00065673,237,117,120,49.36708860759494,50.63291139240506
E00185489,206,101,105,49.029126213592235,50.970873786407765
E00185543,461,231,230,50.108459869848154,49.891540130151846
E00065681,404,205,199,50.742574257425744,49.257425742574256
E00065682,344,180,164,52.32558139534884,47.674418604651166
E00065683,402,204,198,50.74626865671642,49.25373134328358
E00065706,408,209,199,51.225490196078425,48.77450980392157
E00065707,311,151,160,48.55305466237942,51.446945337620576
E00065976,322,159,163,49.378881987577635,50.621118012422365
E00065987,226,110,116,48.67256637168141,51.32743362831859
E00065988,345,177,168,51.30434782608696,48.69565217391305
E00065989,254,128,126,50.39370078740157,49.60629921259843
E00065991,370,179,191,48.37837837837838,51.621621621621614
E00065995,343,163,180,47.521865889212826,52.47813411078717
E00065996,175,88,87,50.28571428571429,49.714285714285715
E00066007,306,150,156,49.01960784313725,50.98039215686274
E00066009,232,116,116,50,50
E00066039,235,131,104,55.74468085106383,44.25531914893617
E00066041,292,146,146,50,50
E00066025,312,164,148,52.56410256410257,47.43589743589743
E00066026,236,127,109,53.813559322033896,46.186440677966104
E00066027,302,149,153,49.337748344370866,50.66225165562914
E00066028,309,160,149,51.7799352750809,48.22006472491909
E00066042,205,103,102,50.24390243902439,49.75609756097561
E00066023,267,129,138,48.31460674157304,51.68539325842697
E00066024,304,161,143,52.960526315789465,47.03947368421053
E00066029,291,130,161,44.67353951890035,55.32646048109966
E00066030,248,127,121,51.20967741935484,48.79032258064516
E00066033,289,140,149,48.44290657439446,51.55709342560554
E00066034,270,144,126,53.333333333333336,46.666666666666664
E00066035,357,196,161,54.90196078431373,45.09803921568628
E00066036,193,106,87,54.92227979274611,45.07772020725388
E00066037,264,137,127,51.89393939393939,48.10606060606061
E00066038,219,108,111,49.31506849315068,50.68493150684932
E00066008,316,158,158,50,50
E00066010,227,113,114,49.77973568281938,50.22026431718062
E00066011,277,151,126,54.51263537906137,45.48736462093863
E00066012,337,165,172,48.96142433234421,51.038575667655785
E00066013,308,161,147,52.27272727272727,47.72727272727273
E00065992,366,181,185,49.45355191256831,50.54644808743169
E00065993,309,148,161,47.896440129449836,52.103559870550164
E00065997,237,114,123,48.10126582278481,51.89873417721519
E00066019,147,80,67,54.421768707483,45.57823129251701
E00066021,291,139,152,47.766323024054984,52.23367697594502
E00065553,264,135,129,51.13636363636363,48.86363636363637
E00065554,252,142,110,56.34920634920635,43.65079365079365
E00065556,281,145,136,51.60142348754449,48.39857651245551
E00065559,290,148,142,51.03448275862069,48.96551724137931
E00065568,387,198,189,51.162790697674424,48.837209302325576
E00065548,318,156,162,49.056603773584904,50.943396226415096
E00065549,347,158,189,45.53314121037464,54.46685878962536
E00065565,319,166,153,52.03761755485894,47.96238244514107
E00065572,360,176,184,48.888888888888886,51.11111111111111
E00065573,280,146,134,52.142857142857146,47.85714285714286
E00065574,303,166,137,54.78547854785478,45.21452145214521
E00065585,351,164,187,46.72364672364672,53.27635327635327
E00065586,350,180,170,51.42857142857142,48.57142857142857
E00065589,300,157,143,52.33333333333333,47.66666666666667
E00065590,371,169,202,45.55256064690027,54.44743935309974
E00065605,314,168,146,53.503184713375795,46.496815286624205
E00065581,292,145,147,49.65753424657534,50.34246575342466
E00065583,315,158,157,50.15873015873016,49.84126984126984
E00065591,300,149,151,49.666666666666664,50.33333333333333
E00065600,268,137,131,51.11940298507462,48.88059701492538
E00065604,215,116,99,53.95348837209303,46.04651162790698
E00065610,408,207,201,50.73529411764706,49.26470588235294
E00065961,250,124,126,49.6,50.4
E00065962,251,133,118,52.98804780876494,47.01195219123506
E00065963,228,109,119,47.80701754385965,52.19298245614035
E00065970,414,204,210,49.275362318840585,50.72463768115942
E00065972,283,143,140,50.53003533568905,49.46996466431096
E00065990,176,85,91,48.29545454545455,51.70454545454546
E00065558,301,154,147,51.162790697674424,48.837209302325576
E00065561,248,131,117,52.82258064516129,47.17741935483871
E00065562,350,178,172,50.857142857142854,49.142857142857146
E00065564,384,203,181,52.864583333333336,47.13541666666667
E00065566,288,160,128,55.55555555555556,44.44444444444444
E00065569,289,150,139,51.903114186851205,48.09688581314879
E00065552,371,188,183,50.673854447439346,49.32614555256065
E00065557,304,152,152,50,50
E00065563,327,173,154,52.90519877675841,47.09480122324159
E00065567,360,204,156,56.666666666666664,43.333333333333336
E00065570,198,109,89,55.05050505050505,44.94949494949495
E00065571,366,187,179,51.09289617486339,48.90710382513661
E00065580,404,195,209,48.26732673267327,51.73267326732673
E00065582,444,205,239,46.171171171171174,53.82882882882883
E00065587,216,88,128,40.74074074074074,59.25925925925925
E00065588,370,168,202,45.40540540540541,54.59459459459459
E00065592,360,171,189,47.5,52.5
E00065595,400,169,231,42.25,57.75
E00065593,533,278,255,52.15759849906192,47.84240150093809
E00065594,307,154,153,50.1628664495114,49.8371335504886
E00065596,350,180,170,51.42857142857142,48.57142857142857
E00065597,336,162,174,48.214285714285715,51.78571428571429
E00065598,302,151,151,50,50
E00065584,360,179,181,49.72222222222222,50.27777777777778
E00065602,338,173,165,51.183431952662716,48.81656804733728
E00065606,327,161,166,49.235474006116206,50.764525993883794
E00065608,345,187,158,54.20289855072464,45.79710144927536
E00065609,414,191,223,46.13526570048309,53.864734299516904
E00065969,474,234,240,49.36708860759494,50.63291139240506
E00065971,362,193,169,53.31491712707182,46.68508287292818
E00065973,326,155,171,47.54601226993865,52.45398773006135
E00065974,271,141,130,52.02952029520295,47.97047970479705
E00065975,248,128,120,51.61290322580645,48.38709677419355
E00065977,344,169,175,49.127906976744185,50.872093023255815
E00065980,311,155,156,49.839228295819936,50.160771704180064
E00065981,225,109,116,48.44444444444444,51.55555555555556
E00065986,272,144,128,52.94117647058824,47.05882352941176
E00185554,296,137,159,46.28378378378378,53.71621621621622
E00185557,351,182,169,51.85185185185185,48.148148148148145
E00065964,340,168,172,49.411764705882355,50.588235294117645
E00065965,371,190,181,51.21293800539084,48.78706199460917
E00065966,131,69,62,52.67175572519084,47.32824427480916
E00065967,214,107,107,50,50
E00065968,282,143,139,50.70921985815603,49.29078014184397
E00065978,378,192,186,50.79365079365079,49.2063492063492
E00065983,327,173,154,52.90519877675841,47.09480122324159
E00065984,300,159,141,53,47
E00065985,314,172,142,54.77707006369427,45.22292993630573
E00174848,249,125,124,50.20080321285141,49.79919678714859
E00175332,287,149,138,51.91637630662021,48.08362369337979
E00175348,211,115,96,54.502369668246445,45.497630331753555
E00065626,317,157,160,49.52681388012618,50.473186119873816
E00065630,283,138,145,48.76325088339223,51.23674911660777
E00065635,337,163,174,48.367952522255194,51.632047477744806
E00065642,304,158,146,51.973684210526315,48.026315789473685
E00065647,286,153,133,53.4965034965035,46.50349650349651
E00065614,281,133,148,47.330960854092524,52.66903914590747
E00065615,379,187,192,49.340369393139845,50.65963060686016
E00065617,318,164,154,51.57232704402516,48.42767295597484
E00065622,160,89,71,55.625,44.375
E00065623,283,148,135,52.29681978798587,47.70318021201413
E00066117,254,117,137,46.06299212598425,53.937007874015755
E00066130,251,147,104,58.56573705179283,41.43426294820717
E00066132,248,135,113,54.43548387096774,45.564516129032256
E00066135,275,141,134,51.272727272727266,48.72727272727273
E00066137,307,162,145,52.76872964169381,47.23127035830619
E00066122,341,175,166,51.31964809384164,48.68035190615836
E00066126,228,118,110,51.75438596491229,48.24561403508772
E00066127,292,158,134,54.109589041095894,45.89041095890411
E00066134,302,149,153,49.337748344370866,50.66225165562914
E00066119,340,176,164,51.76470588235295,48.23529411764706
E00066123,234,114,120,48.717948717948715,51.28205128205128
E00066129,272,146,126,53.67647058823529,46.32352941176471
E00066143,339,172,167,50.737463126843664,49.26253687315634
E00066141,146,79,67,54.109589041095894,45.89041095890411
E00066145,247,136,111,55.06072874493927,44.93927125506073
E00066146,333,161,172,48.348348348348345,51.651651651651655
E00066149,326,167,159,51.22699386503068,48.77300613496933
E00165823,352,171,181,48.57954545454545,51.42045454545454
E00065463,239,116,123,48.53556485355649,51.46443514644351
E00065481,407,215,192,52.825552825552826,47.174447174447174
E00065483,362,185,177,51.10497237569061,48.89502762430939
E00065488,290,158,132,54.48275862068965,45.51724137931035
E00065490,268,134,134,50,50
E00065517,405,212,193,52.345679012345684,47.654320987654316
E00065520,271,137,134,50.55350553505535,49.44649446494465
E00065529,289,150,139,51.903114186851205,48.09688581314879
E00065533,535,260,275,48.598130841121495,51.4018691588785
E00065539,339,158,181,46.607669616519175,53.392330383480825
E00065528,263,146,117,55.51330798479087,44.48669201520912
E00065530,381,200,181,52.493438320209975,47.506561679790025
E00065531,285,141,144,49.473684210526315,50.526315789473685
E00065532,232,119,113,51.293103448275865,48.706896551724135
E00065534,252,135,117,53.57142857142857,46.42857142857143
E00065535,299,153,146,51.17056856187291,48.82943143812709
E00175333,356,178,178,50,50
E00175355,498,262,236,52.610441767068274,47.389558232931726
E00175356,494,256,238,51.821862348178136,48.178137651821864
E00175357,204,107,97,52.450980392156865,47.549019607843135
E00065467,274,147,127,53.64963503649635,46.35036496350365
E00065474,571,287,284,50.26269702276708,49.73730297723292
E00065478,304,140,164,46.05263157894737,53.94736842105263
E00175352,288,157,131,54.513888888888886,45.48611111111111
E00065484,299,155,144,51.83946488294314,48.16053511705686
E00065485,203,113,90,55.66502463054187,44.33497536945813
E00065487,314,156,158,49.681528662420384,50.318471337579616
E00065489,211,113,98,53.55450236966824,46.44549763033176
E00065492,280,146,134,52.142857142857146,47.85714285714286
E00065453,238,131,107,55.04201680672269,44.957983193277315
E00065454,283,134,149,47.349823321554766,52.65017667844523
E00065464,323,176,147,54.4891640866873,45.51083591331269
E00065466,244,130,114,53.278688524590166,46.72131147540984
E00065469,246,128,118,52.03252032520326,47.96747967479675
E00065482,402,207,195,51.49253731343284,48.507462686567166
E00065456,257,133,124,51.75097276264592,48.249027237354085
E00065465,329,175,154,53.191489361702125,46.808510638297875
E00065470,269,148,121,55.01858736059479,44.98141263940521
E00065472,234,124,110,52.991452991452995,47.008547008547005
E00065477,349,187,162,53.581661891117484,46.41833810888252
E00065491,216,129,87,59.72222222222222,40.27777777777778
E00065457,306,152,154,49.673202614379086,50.326797385620914
E00065459,325,167,158,51.38461538461539,48.61538461538461
E00065471,235,107,128,45.53191489361702,54.46808510638298
E00065473,200,107,93,53.5,46.5
E00065479,288,153,135,53.125,46.875
E00065480,166,89,77,53.6144578313253,46.3855421686747
