OA,ts0540001,ts0540002,ts0540003,ts0540004,ts0540005,ts0540006,ts0540007,ts0540008,ts0540009,ts0540010,ts0540011,ts0540012,ts0540013,ts0540002_PCT,ts0540003_PCT,ts0540004_PCT,ts0540005_PCT,ts0540006_PCT,ts0540007_PCT,ts0540008_PCT,ts0540009_PCT,ts0540010_PCT,ts0540011_PCT,ts0540012_PCT,ts0540013_PCT
E00126457,129,126,80,46,0,0,2,1,1,1,1,0,0,97.67441860465115,62.01550387596899,35.65891472868217,0,0,1.550387596899225,0.7751937984496124,0.7751937984496124,0.7751937984496124,0.7751937984496124,0,0
E00126458,249,206,89,117,0,0,25,4,21,18,16,2,0,82.73092369477911,35.7429718875502,46.98795180722892,0,0,10.040160642570282,1.6064257028112447,8.433734939759036,7.228915662650602,6.425702811244979,0.8032128514056224,0
E00126459,178,145,81,64,0,0,3,0,3,30,25,5,0,81.46067415730337,45.50561797752809,35.95505617977528,0,0,1.6853932584269662,0,1.6853932584269662,16.853932584269664,14.04494382022472,2.8089887640449436,0
E00126460,124,105,69,36,0,0,0,0,0,19,17,2,0,84.67741935483872,55.64516129032258,29.03225806451613,0,0,0,0,0,15.32258064516129,13.709677419354838,1.6129032258064515,0
E00126461,122,99,46,53,1,1,0,0,0,22,21,1,0,81.14754098360656,37.704918032786885,43.44262295081967,0.819672131147541,0.819672131147541,0,0,0,18.0327868852459,17.21311475409836,0.819672131147541,0
E00126462,134,117,72,45,0,0,2,1,1,15,9,6,0,87.31343283582089,53.73134328358209,33.582089552238806,0,0,1.4925373134328357,0.7462686567164178,0.7462686567164178,11.194029850746269,6.7164179104477615,4.477611940298507,0
E00126463,116,73,39,34,1,1,13,3,10,29,24,5,0,62.93103448275862,33.62068965517241,29.310344827586203,0.8620689655172413,0.8620689655172413,11.206896551724139,2.586206896551724,8.620689655172415,25,20.689655172413794,4.310344827586207,0
E00126464,121,83,42,41,0,0,4,0,4,34,31,3,0,68.59504132231406,34.710743801652896,33.88429752066116,0,0,3.3057851239669422,0,3.3057851239669422,28.09917355371901,25.6198347107438,2.479338842975207,0
E00126465,137,83,36,47,0,0,27,8,19,27,26,1,0,60.58394160583942,26.277372262773724,34.306569343065696,0,0,19.708029197080293,5.839416058394161,13.86861313868613,19.708029197080293,18.97810218978102,0.7299270072992701,0
E00126466,200,119,77,42,0,0,25,5,20,56,50,6,0,59.5,38.5,21,0,0,12.5,2.5,10,28.000000000000004,25,3,0
E00126467,118,51,30,21,0,0,55,18,37,12,11,1,0,43.22033898305085,25.423728813559322,17.796610169491526,0,0,46.61016949152542,15.254237288135593,31.35593220338983,10.16949152542373,9.322033898305085,0.847457627118644,0
E00126468,163,146,107,39,1,1,0,0,0,16,12,4,0,89.57055214723927,65.6441717791411,23.92638036809816,0.6134969325153374,0.6134969325153374,0,0,0,9.815950920245399,7.361963190184049,2.4539877300613497,0
E00126469,106,89,60,29,0,0,1,1,0,16,14,2,0,83.9622641509434,56.60377358490566,27.358490566037734,0,0,0.9433962264150944,0.9433962264150944,0,15.09433962264151,13.20754716981132,1.8867924528301887,0
E00126470,128,95,50,45,0,0,3,2,1,30,27,3,0,74.21875,39.0625,35.15625,0,0,2.34375,1.5625,0.78125,23.4375,21.09375,2.34375,0
E00126471,196,177,90,87,0,0,1,0,1,18,16,2,0,90.3061224489796,45.91836734693878,44.38775510204081,0,0,0.5102040816326531,0,0.5102040816326531,9.183673469387756,8.16326530612245,1.0204081632653061,0
E00126472,157,91,54,37,1,1,16,5,11,49,45,4,0,57.961783439490446,34.394904458598724,23.56687898089172,0.6369426751592357,0.6369426751592357,10.191082802547772,3.1847133757961785,7.006369426751593,31.210191082802545,28.662420382165603,2.547770700636943,0
E00126474,114,57,29,28,0,0,45,10,35,12,9,3,0,50,25.438596491228072,24.561403508771928,0,0,39.473684210526315,8.771929824561402,30.701754385964914,10.526315789473683,7.894736842105263,2.631578947368421,0
E00126475,179,133,63,70,0,0,7,2,5,39,36,3,0,74.30167597765363,35.19553072625698,39.10614525139665,0,0,3.910614525139665,1.1173184357541899,2.793296089385475,21.787709497206702,20.11173184357542,1.675977653631285,0
E00126476,131,106,61,45,0,0,2,1,1,23,21,2,0,80.91603053435115,46.56488549618321,34.35114503816794,0,0,1.5267175572519083,0.7633587786259541,0.7633587786259541,17.557251908396946,16.030534351145036,1.5267175572519083,0
E00126477,134,95,48,47,1,1,14,3,11,24,21,3,0,70.8955223880597,35.82089552238806,35.07462686567165,0.7462686567164178,0.7462686567164178,10.44776119402985,2.2388059701492535,8.208955223880597,17.91044776119403,15.671641791044777,2.2388059701492535,0
E00126478,107,99,68,31,0,0,0,0,0,8,8,0,0,92.5233644859813,63.55140186915887,28.971962616822427,0,0,0,0,0,7.476635514018691,7.476635514018691,0,0
E00126479,77,43,25,18,0,0,25,8,17,9,7,2,0,55.84415584415584,32.467532467532465,23.376623376623375,0,0,32.467532467532465,10.38961038961039,22.07792207792208,11.688311688311687,9.090909090909092,2.5974025974025974,0
E00126480,128,112,66,46,0,0,3,0,3,13,11,2,0,87.5,51.5625,35.9375,0,0,2.34375,0,2.34375,10.15625,8.59375,1.5625,0
E00126481,164,148,92,56,0,0,0,0,0,16,13,3,0,90.2439024390244,56.09756097560976,34.146341463414636,0,0,0,0,0,9.75609756097561,7.926829268292683,1.8292682926829267,0
E00126482,130,27,12,15,0,0,94,7,87,9,8,1,0,20.76923076923077,9.230769230769232,11.538461538461538,0,0,72.3076923076923,5.384615384615385,66.92307692307692,6.923076923076923,6.153846153846154,0.7692307692307693,0
E00126483,157,114,63,51,1,1,0,0,0,42,40,2,0,72.61146496815286,40.12738853503185,32.48407643312102,0.6369426751592357,0.6369426751592357,0,0,0,26.751592356687897,25.477707006369428,1.2738853503184715,0
E00126484,117,4,4,0,0,0,98,8,90,15,14,1,0,3.418803418803419,3.418803418803419,0,0,0,83.76068376068376,6.837606837606838,76.92307692307693,12.82051282051282,11.965811965811966,0.8547008547008548,0
E00126485,125,121,90,31,0,0,0,0,0,4,4,0,0,96.8,72,24.8,0,0,0,0,0,3.2,3.2,0,0
E00126486,126,111,78,33,0,0,1,0,1,14,11,3,0,88.09523809523809,61.904761904761905,26.190476190476193,0,0,0.7936507936507936,0,0.7936507936507936,11.11111111111111,8.73015873015873,2.380952380952381,0
E00126487,121,118,100,18,0,0,0,0,0,3,2,1,0,97.52066115702479,82.64462809917356,14.87603305785124,0,0,0,0,0,2.479338842975207,1.6528925619834711,0.8264462809917356,0
E00126488,131,116,80,36,1,1,0,0,0,14,11,3,0,88.54961832061069,61.06870229007634,27.480916030534353,0.7633587786259541,0.7633587786259541,0,0,0,10.687022900763358,8.396946564885496,2.2900763358778624,0
E00126489,107,22,12,10,2,2,74,6,68,9,9,0,0,20.5607476635514,11.214953271028037,9.345794392523365,1.8691588785046727,1.8691588785046727,69.1588785046729,5.607476635514018,63.55140186915887,8.411214953271028,8.411214953271028,0,0
E00126490,104,36,17,19,0,0,57,6,51,11,9,2,0,34.61538461538461,16.346153846153847,18.269230769230766,0,0,54.807692307692314,5.769230769230769,49.03846153846153,10.576923076923077,8.653846153846153,1.9230769230769231,0
E00126491,113,12,5,7,0,0,94,6,88,7,6,1,0,10.619469026548673,4.424778761061947,6.1946902654867255,0,0,83.1858407079646,5.3097345132743365,77.87610619469027,6.1946902654867255,5.3097345132743365,0.8849557522123894,0
E00126493,124,102,64,38,0,0,2,0,2,20,17,3,0,82.25806451612904,51.61290322580645,30.64516129032258,0,0,1.6129032258064515,0,1.6129032258064515,16.129032258064516,13.709677419354838,2.4193548387096775,0
E00126494,127,109,70,39,0,0,3,0,3,15,9,6,0,85.8267716535433,55.118110236220474,30.708661417322837,0,0,2.3622047244094486,0,2.3622047244094486,11.811023622047244,7.086614173228346,4.724409448818897,0
E00126495,170,146,89,57,1,1,0,0,0,23,17,6,0,85.88235294117646,52.352941176470594,33.52941176470588,0.5882352941176471,0.5882352941176471,0,0,0,13.529411764705882,10,3.5294117647058822,0
E00126496,116,83,49,34,0,0,1,0,1,32,28,4,0,71.55172413793103,42.241379310344826,29.310344827586203,0,0,0.8620689655172413,0,0.8620689655172413,27.586206896551722,24.137931034482758,3.4482758620689653,0
E00126497,109,93,63,30,1,1,9,0,9,6,6,0,0,85.3211009174312,57.798165137614674,27.522935779816514,0.9174311926605505,0.9174311926605505,8.256880733944955,0,8.256880733944955,5.5045871559633035,5.5045871559633035,0,0
E00126498,117,102,57,45,0,0,0,0,0,15,13,2,0,87.17948717948718,48.717948717948715,38.46153846153847,0,0,0,0,0,12.82051282051282,11.11111111111111,1.7094017094017095,0
E00126499,136,116,73,43,0,0,0,0,0,20,12,8,0,85.29411764705883,53.67647058823529,31.61764705882353,0,0,0,0,0,14.705882352941178,8.823529411764707,5.88235294117647,0
E00126500,106,88,57,31,0,0,11,5,6,7,4,3,0,83.01886792452831,53.77358490566038,29.245283018867923,0,0,10.377358490566039,4.716981132075472,5.660377358490567,6.60377358490566,3.7735849056603774,2.8301886792452833,0
E00126501,142,123,72,51,1,1,9,3,6,9,6,3,0,86.61971830985915,50.70422535211267,35.91549295774648,0.7042253521126761,0.7042253521126761,6.338028169014084,2.112676056338028,4.225352112676056,6.338028169014084,4.225352112676056,2.112676056338028,0
E00126502,157,132,84,48,0,0,6,0,6,19,14,5,0,84.07643312101911,53.503184713375795,30.573248407643312,0,0,3.821656050955414,0,3.821656050955414,12.101910828025478,8.9171974522293,3.1847133757961785,0
E00126503,115,110,67,43,0,0,1,0,1,4,4,0,0,95.65217391304348,58.26086956521739,37.391304347826086,0,0,0.8695652173913043,0,0.8695652173913043,3.4782608695652173,3.4782608695652173,0,0
E00126504,135,123,73,50,5,5,4,0,4,3,1,2,0,91.11111111111111,54.074074074074076,37.03703703703704,3.7037037037037033,3.7037037037037033,2.9629629629629632,0,2.9629629629629632,2.2222222222222223,0.7407407407407408,1.4814814814814816,0
E00126505,140,88,48,40,1,1,47,9,38,4,4,0,0,62.857142857142854,34.285714285714285,28.57142857142857,0.7142857142857143,0.7142857142857143,33.57142857142857,6.428571428571428,27.142857142857142,2.857142857142857,2.857142857142857,0,0
E00126506,114,75,38,37,0,0,7,1,6,32,27,5,0,65.78947368421053,33.33333333333333,32.45614035087719,0,0,6.140350877192982,0.8771929824561403,5.263157894736842,28.07017543859649,23.684210526315788,4.385964912280701,0
E00126507,125,114,74,40,0,0,3,0,3,8,7,1,0,91.2,59.199999999999996,32,0,0,2.4,0,2.4,6.4,5.6000000000000005,0.8,0
E00126508,223,185,68,117,0,0,14,6,8,24,20,4,0,82.95964125560538,30.493273542600896,52.46636771300448,0,0,6.278026905829597,2.690582959641256,3.587443946188341,10.762331838565023,8.968609865470851,1.7937219730941705,0
E00126509,131,115,76,39,1,1,9,3,6,6,5,1,0,87.78625954198473,58.01526717557252,29.770992366412212,0.7633587786259541,0.7633587786259541,6.870229007633588,2.2900763358778624,4.580152671755725,4.580152671755725,3.816793893129771,0.7633587786259541,0
E00126510,170,149,92,57,0,0,11,4,7,10,10,0,0,87.6470588235294,54.11764705882353,33.52941176470588,0,0,6.470588235294119,2.3529411764705883,4.117647058823529,5.88235294117647,5.88235294117647,0,0
E00126511,104,92,52,40,0,0,5,0,5,7,5,2,0,88.46153846153845,50,38.46153846153847,0,0,4.807692307692308,0,4.807692307692308,6.730769230769231,4.807692307692308,1.9230769230769231,0
E00126512,119,106,68,38,0,0,1,0,1,12,9,3,0,89.07563025210085,57.14285714285714,31.932773109243694,0,0,0.8403361344537815,0,0.8403361344537815,10.084033613445378,7.563025210084033,2.5210084033613445,0
E00126513,138,64,38,26,0,0,33,10,23,41,41,0,0,46.3768115942029,27.536231884057973,18.84057971014493,0,0,23.91304347826087,7.246376811594203,16.666666666666664,29.71014492753623,29.71014492753623,0,0
E00126514,148,94,55,39,0,0,12,2,10,42,36,6,0,63.51351351351351,37.16216216216216,26.351351351351347,0,0,8.108108108108109,1.3513513513513513,6.756756756756757,28.37837837837838,24.324324324324326,4.054054054054054,0
E00126515,133,117,82,35,0,0,0,0,0,16,15,1,0,87.96992481203007,61.65413533834586,26.31578947368421,0,0,0,0,0,12.030075187969924,11.278195488721805,0.7518796992481203,0
E00126516,129,118,46,72,0,0,0,0,0,11,11,0,0,91.47286821705426,35.65891472868217,55.81395348837209,0,0,0,0,0,8.527131782945736,8.527131782945736,0,0
E00126517,132,67,31,36,0,0,27,3,24,38,32,6,0,50.75757575757576,23.484848484848484,27.27272727272727,0,0,20.454545454545457,2.272727272727273,18.181818181818183,28.78787878787879,24.242424242424242,4.545454545454546,0
E00126518,233,131,47,84,0,0,71,7,64,31,29,2,0,56.22317596566524,20.171673819742487,36.05150214592275,0,0,30.472103004291846,3.004291845493562,27.467811158798284,13.304721030042918,12.446351931330472,0.8583690987124464,0
E00126519,149,23,16,7,1,1,64,19,45,60,57,3,1,15.436241610738255,10.738255033557047,4.697986577181208,0.6711409395973155,0.6711409395973155,42.95302013422819,12.751677852348994,30.201342281879196,40.26845637583892,38.25503355704698,2.013422818791946,0.6711409395973155
E00126520,186,164,88,76,0,0,5,1,4,17,15,2,0,88.17204301075269,47.31182795698925,40.86021505376344,0,0,2.6881720430107525,0.5376344086021506,2.1505376344086025,9.13978494623656,8.064516129032258,1.0752688172043012,0
E00126521,141,127,92,35,0,0,0,0,0,14,13,1,0,90.0709219858156,65.24822695035462,24.822695035460992,0,0,0,0,0,9.929078014184398,9.219858156028367,0.7092198581560284,0
E00126522,114,57,34,23,0,0,33,3,30,24,20,4,0,50,29.82456140350877,20.175438596491226,0,0,28.947368421052634,2.631578947368421,26.31578947368421,21.052631578947366,17.543859649122805,3.508771929824561,0
E00126523,134,65,27,38,0,0,30,7,23,39,32,7,0,48.507462686567166,20.149253731343283,28.35820895522388,0,0,22.388059701492537,5.223880597014925,17.16417910447761,29.1044776119403,23.88059701492537,5.223880597014925,0
E00126524,129,91,43,48,0,0,8,0,8,30,24,6,0,70.54263565891473,33.33333333333333,37.2093023255814,0,0,6.2015503875969,0,6.2015503875969,23.25581395348837,18.6046511627907,4.651162790697675,0
E00126526,130,59,28,31,0,0,45,10,35,26,25,1,0,45.38461538461539,21.53846153846154,23.846153846153847,0,0,34.61538461538461,7.6923076923076925,26.923076923076923,20,19.230769230769234,0.7692307692307693,0
E00126527,112,66,29,37,0,0,25,6,19,20,17,3,1,58.92857142857143,25.892857142857146,33.035714285714285,0,0,22.321428571428573,5.357142857142857,16.964285714285715,17.857142857142858,15.178571428571427,2.6785714285714284,0.8928571428571428
E00126528,113,62,31,31,2,2,39,19,20,10,9,1,0,54.86725663716814,27.43362831858407,27.43362831858407,1.7699115044247788,1.7699115044247788,34.51327433628318,16.8141592920354,17.699115044247787,8.849557522123893,7.964601769911504,0.8849557522123894,0
E00126529,124,47,20,27,0,0,42,12,30,34,33,1,1,37.903225806451616,16.129032258064516,21.774193548387096,0,0,33.87096774193548,9.67741935483871,24.193548387096776,27.419354838709676,26.61290322580645,0.8064516129032258,0.8064516129032258
E00126530,125,40,21,19,0,0,64,18,46,21,21,0,0,32,16.8,15.2,0,0,51.2,14.399999999999999,36.8,16.8,16.8,0,0
E00126531,121,51,23,28,0,0,33,10,23,36,34,2,1,42.14876033057851,19.00826446280992,23.140495867768596,0,0,27.27272727272727,8.264462809917356,19.00826446280992,29.75206611570248,28.09917355371901,1.6528925619834711,0.8264462809917356
E00126532,131,45,25,20,0,0,40,4,36,46,38,8,0,34.35114503816794,19.083969465648856,15.267175572519085,0,0,30.53435114503817,3.0534351145038165,27.480916030534353,35.11450381679389,29.00763358778626,6.106870229007633,0
E00126533,134,64,24,40,0,0,23,6,17,47,35,12,0,47.76119402985074,17.91044776119403,29.850746268656714,0,0,17.16417910447761,4.477611940298507,12.686567164179104,35.07462686567165,26.119402985074625,8.955223880597014,0
E00126534,140,45,26,19,0,0,69,13,56,26,25,1,0,32.142857142857146,18.571428571428573,13.571428571428571,0,0,49.28571428571429,9.285714285714286,40,18.571428571428573,17.857142857142858,0.7142857142857143,0
E00126535,125,37,13,24,2,2,77,17,60,9,9,0,0,29.599999999999998,10.4,19.2,1.6,1.6,61.6,13.600000000000001,48,7.199999999999999,7.199999999999999,0,0
E00126536,134,88,37,51,0,0,32,12,20,14,12,2,0,65.67164179104478,27.611940298507463,38.059701492537314,0,0,23.88059701492537,8.955223880597014,14.925373134328357,10.44776119402985,8.955223880597014,1.4925373134328357,0
E00126537,124,55,28,27,1,1,38,10,28,30,30,0,0,44.354838709677416,22.58064516129032,21.774193548387096,0.8064516129032258,0.8064516129032258,30.64516129032258,8.064516129032258,22.58064516129032,24.193548387096776,24.193548387096776,0,0
E00126538,150,123,75,48,0,0,17,2,15,10,7,3,0,82,50,32,0,0,11.333333333333332,1.3333333333333335,10,6.666666666666667,4.666666666666667,2,0
E00126539,147,110,56,54,4,4,8,0,8,25,23,2,0,74.82993197278913,38.095238095238095,36.734693877551024,2.7210884353741496,2.7210884353741496,5.442176870748299,0,5.442176870748299,17.006802721088434,15.646258503401361,1.3605442176870748,0
E00126540,135,86,40,46,1,1,26,3,23,22,18,4,0,63.70370370370371,29.629629629629626,34.074074074074076,0.7407407407407408,0.7407407407407408,19.25925925925926,2.2222222222222223,17.037037037037038,16.296296296296298,13.333333333333334,2.9629629629629632,0
E00126541,145,71,36,35,0,0,24,1,23,50,46,4,0,48.96551724137931,24.82758620689655,24.137931034482758,0,0,16.551724137931036,0.6896551724137931,15.862068965517242,34.48275862068966,31.724137931034484,2.7586206896551726,0
E00126542,111,59,21,38,0,0,10,3,7,42,37,5,0,53.153153153153156,18.91891891891892,34.234234234234236,0,0,9.00900900900901,2.7027027027027026,6.306306306306306,37.83783783783784,33.33333333333333,4.504504504504505,0
E00126543,133,83,41,42,0,0,24,5,19,26,22,4,0,62.40601503759399,30.82706766917293,31.57894736842105,0,0,18.045112781954884,3.7593984962406015,14.285714285714285,19.548872180451127,16.541353383458645,3.007518796992481,0
E00126544,113,44,21,23,0,0,32,2,30,36,34,2,1,38.93805309734513,18.58407079646018,20.353982300884958,0,0,28.31858407079646,1.7699115044247788,26.548672566371685,31.858407079646017,30.08849557522124,1.7699115044247788,0.8849557522123894
E00126545,128,50,16,34,1,1,38,8,30,39,38,1,0,39.0625,12.5,26.5625,0.78125,0.78125,29.6875,6.25,23.4375,30.46875,29.6875,0.78125,0
E00126546,142,87,37,50,3,3,11,1,10,41,36,5,0,61.267605633802816,26.056338028169012,35.2112676056338,2.112676056338028,2.112676056338028,7.746478873239436,0.7042253521126761,7.042253521126761,28.87323943661972,25.352112676056336,3.5211267605633805,0
E00126547,126,62,33,29,0,0,21,1,20,43,40,3,0,49.2063492063492,26.190476190476193,23.015873015873016,0,0,16.666666666666664,0.7936507936507936,15.873015873015872,34.12698412698413,31.746031746031743,2.380952380952381,0
E00126548,140,109,51,58,0,0,11,5,6,20,18,2,0,77.85714285714286,36.42857142857142,41.42857142857143,0,0,7.857142857142857,3.571428571428571,4.285714285714286,14.285714285714285,12.857142857142856,1.4285714285714286,0
E00126549,117,112,68,44,0,0,1,0,1,4,4,0,0,95.72649572649573,58.119658119658126,37.60683760683761,0,0,0.8547008547008548,0,0.8547008547008548,3.418803418803419,3.418803418803419,0,0
E00126550,126,119,78,41,0,0,2,0,2,5,2,3,0,94.44444444444444,61.904761904761905,32.53968253968254,0,0,1.5873015873015872,0,1.5873015873015872,3.968253968253968,1.5873015873015872,2.380952380952381,0
E00126551,103,99,66,33,0,0,1,0,1,3,2,1,0,96.11650485436894,64.07766990291263,32.038834951456316,0,0,0.9708737864077669,0,0.9708737864077669,2.912621359223301,1.9417475728155338,0.9708737864077669,0
E00126552,92,88,60,28,0,0,1,0,1,3,2,1,0,95.65217391304348,65.21739130434783,30.434782608695656,0,0,1.0869565217391304,0,1.0869565217391304,3.260869565217391,2.1739130434782608,1.0869565217391304,0
E00126553,111,99,71,28,1,1,2,0,2,9,7,2,0,89.1891891891892,63.96396396396396,25.225225225225223,0.9009009009009009,0.9009009009009009,1.8018018018018018,0,1.8018018018018018,8.108108108108109,6.306306306306306,1.8018018018018018,0
E00126554,108,91,50,41,0,0,3,0,3,14,13,1,0,84.25925925925925,46.2962962962963,37.96296296296296,0,0,2.7777777777777777,0,2.7777777777777777,12.962962962962962,12.037037037037036,0.9259259259259258,0
E00126555,154,50,20,30,7,7,82,17,65,14,14,0,1,32.467532467532465,12.987012987012985,19.480519480519483,4.545454545454546,4.545454545454546,53.246753246753244,11.03896103896104,42.2077922077922,9.090909090909092,9.090909090909092,0,0.6493506493506493
E00126556,151,42,24,18,1,1,81,3,78,27,23,4,0,27.81456953642384,15.894039735099339,11.920529801324504,0.6622516556291391,0.6622516556291391,53.64238410596026,1.9867549668874174,51.65562913907284,17.880794701986755,15.2317880794702,2.6490066225165565,0
E00126557,92,39,17,22,1,1,17,1,16,35,29,6,0,42.391304347826086,18.478260869565215,23.91304347826087,1.0869565217391304,1.0869565217391304,18.478260869565215,1.0869565217391304,17.391304347826086,38.04347826086957,31.521739130434785,6.521739130434782,0
E00126558,133,123,98,25,1,1,1,1,0,8,7,1,0,92.4812030075188,73.68421052631578,18.796992481203006,0.7518796992481203,0.7518796992481203,0.7518796992481203,0.7518796992481203,0,6.015037593984962,5.263157894736842,0.7518796992481203,0
E00126559,118,111,68,43,0,0,2,0,2,5,5,0,0,94.0677966101695,57.6271186440678,36.440677966101696,0,0,1.694915254237288,0,1.694915254237288,4.23728813559322,4.23728813559322,0,0
E00126560,127,103,66,37,0,0,9,2,7,15,12,3,0,81.10236220472441,51.96850393700787,29.133858267716533,0,0,7.086614173228346,1.574803149606299,5.511811023622047,11.811023622047244,9.448818897637794,2.3622047244094486,0
E00126561,200,61,28,33,0,0,63,57,6,76,70,6,0,30.5,14.000000000000002,16.5,0,0,31.5,28.499999999999996,3,38,35,3,0
E00126562,124,95,50,45,1,1,2,0,2,26,24,2,0,76.61290322580645,40.32258064516129,36.29032258064516,0.8064516129032258,0.8064516129032258,1.6129032258064515,0,1.6129032258064515,20.967741935483872,19.35483870967742,1.6129032258064515,0
E00126563,142,119,73,46,1,1,16,5,11,6,5,1,0,83.80281690140845,51.40845070422535,32.3943661971831,0.7042253521126761,0.7042253521126761,11.267605633802818,3.5211267605633805,7.746478873239436,4.225352112676056,3.5211267605633805,0.7042253521126761,0
E00126564,141,102,53,49,0,0,9,0,9,30,26,4,0,72.3404255319149,37.5886524822695,34.751773049645394,0,0,6.382978723404255,0,6.382978723404255,21.27659574468085,18.439716312056735,2.8368794326241136,0
E00126565,138,124,77,47,2,2,1,0,1,11,8,3,0,89.85507246376811,55.79710144927537,34.05797101449276,1.4492753623188406,1.4492753623188406,0.7246376811594203,0,0.7246376811594203,7.971014492753622,5.797101449275362,2.1739130434782608,0
E00126566,167,69,46,23,0,0,10,2,8,88,82,6,0,41.31736526946108,27.54491017964072,13.77245508982036,0,0,5.9880239520958085,1.1976047904191618,4.790419161676647,52.69461077844312,49.101796407185624,3.592814371257485,0
E00126567,120,69,42,27,1,1,4,0,4,46,40,6,0,57.49999999999999,35,22.5,0.8333333333333334,0.8333333333333334,3.3333333333333335,0,3.3333333333333335,38.333333333333336,33.33333333333333,5,0
E00126568,128,121,89,32,0,0,0,0,0,7,7,0,0,94.53125,69.53125,25,0,0,0,0,0,5.46875,5.46875,0,0
E00126569,122,92,44,48,1,1,6,0,6,23,21,2,0,75.40983606557377,36.0655737704918,39.34426229508197,0.819672131147541,0.819672131147541,4.918032786885246,0,4.918032786885246,18.852459016393443,17.21311475409836,1.639344262295082,0
E00126570,122,104,66,38,0,0,2,0,2,16,16,0,0,85.24590163934425,54.09836065573771,31.147540983606557,0,0,1.639344262295082,0,1.639344262295082,13.114754098360656,13.114754098360656,0,0
E00126571,111,102,61,41,0,0,2,0,2,7,6,1,0,91.8918918918919,54.95495495495496,36.93693693693694,0,0,1.8018018018018018,0,1.8018018018018018,6.306306306306306,5.405405405405405,0.9009009009009009,0
E00126572,120,109,79,30,1,1,0,0,0,10,9,1,0,90.83333333333333,65.83333333333333,25,0.8333333333333334,0.8333333333333334,0,0,0,8.333333333333332,7.5,0.8333333333333334,0
E00126573,118,102,65,37,1,1,2,0,2,13,9,4,0,86.4406779661017,55.08474576271186,31.35593220338983,0.847457627118644,0.847457627118644,1.694915254237288,0,1.694915254237288,11.016949152542372,7.627118644067797,3.389830508474576,0
E00126574,125,55,29,26,0,0,3,1,2,67,59,8,0,44,23.200000000000003,20.8,0,0,2.4,0.8,1.6,53.6,47.199999999999996,6.4,0
E00126575,114,83,56,27,16,16,4,1,3,11,8,3,0,72.80701754385966,49.122807017543856,23.684210526315788,14.035087719298245,14.035087719298245,3.508771929824561,0.8771929824561403,2.631578947368421,9.649122807017543,7.017543859649122,2.631578947368421,0
E00126576,161,125,69,56,1,1,17,0,17,18,13,5,0,77.63975155279503,42.857142857142854,34.78260869565217,0.6211180124223602,0.6211180124223602,10.559006211180124,0,10.559006211180124,11.180124223602485,8.074534161490684,3.1055900621118013,0
E00126577,125,112,63,49,0,0,1,1,0,12,9,3,0,89.60000000000001,50.4,39.2,0,0,0.8,0.8,0,9.6,7.199999999999999,2.4,0
E00126578,176,155,80,75,0,0,10,3,7,11,8,3,0,88.06818181818183,45.45454545454545,42.61363636363637,0,0,5.681818181818182,1.7045454545454544,3.977272727272727,6.25,4.545454545454546,1.7045454545454544,0
E00126579,198,180,101,79,3,3,6,0,6,9,7,2,0,90.9090909090909,51.010101010101,39.8989898989899,1.5151515151515151,1.5151515151515151,3.0303030303030303,0,3.0303030303030303,4.545454545454546,3.535353535353535,1.0101010101010102,0
E00126581,129,56,23,33,0,0,49,12,37,24,23,1,0,43.41085271317829,17.829457364341085,25.581395348837212,0,0,37.98449612403101,9.30232558139535,28.68217054263566,18.6046511627907,17.829457364341085,0.7751937984496124,0
E00126582,205,134,44,90,0,0,21,4,17,49,44,5,1,65.3658536585366,21.463414634146343,43.90243902439025,0,0,10.24390243902439,1.951219512195122,8.292682926829269,23.902439024390244,21.463414634146343,2.4390243902439024,0.4878048780487805
E00126583,222,180,75,105,0,0,6,0,6,36,30,6,0,81.08108108108108,33.78378378378378,47.2972972972973,0,0,2.7027027027027026,0,2.7027027027027026,16.216216216216218,13.513513513513514,2.7027027027027026,0
E00126584,141,82,36,46,0,0,29,9,20,30,27,3,0,58.156028368794324,25.53191489361702,32.62411347517731,0,0,20.56737588652482,6.382978723404255,14.184397163120568,21.27659574468085,19.148936170212767,2.127659574468085,0
E00126585,229,157,64,93,1,1,4,1,3,67,55,12,0,68.5589519650655,27.947598253275107,40.61135371179039,0.43668122270742354,0.43668122270742354,1.7467248908296942,0.43668122270742354,1.3100436681222707,29.257641921397383,24.017467248908297,5.240174672489083,0
E00126586,161,46,11,35,0,0,90,5,85,25,22,3,0,28.57142857142857,6.832298136645963,21.73913043478261,0,0,55.90062111801242,3.1055900621118013,52.79503105590062,15.527950310559005,13.664596273291925,1.8633540372670807,0
E00126588,131,25,15,10,1,1,95,29,66,10,8,2,0,19.083969465648856,11.450381679389313,7.633587786259542,0.7633587786259541,0.7633587786259541,72.51908396946564,22.137404580152673,50.38167938931297,7.633587786259542,6.106870229007633,1.5267175572519083,0
E00126589,107,56,27,29,2,2,17,7,10,32,31,1,0,52.336448598130836,25.233644859813083,27.102803738317753,1.8691588785046727,1.8691588785046727,15.887850467289718,6.5420560747663545,9.345794392523365,29.906542056074763,28.971962616822427,0.9345794392523363,0
E00126590,142,110,59,51,0,0,8,3,5,24,21,3,0,77.46478873239437,41.54929577464789,35.91549295774648,0,0,5.633802816901409,2.112676056338028,3.5211267605633805,16.901408450704224,14.788732394366196,2.112676056338028,0
E00126591,124,102,57,45,0,0,6,2,4,16,14,2,0,82.25806451612904,45.96774193548387,36.29032258064516,0,0,4.838709677419355,1.6129032258064515,3.225806451612903,12.903225806451612,11.29032258064516,1.6129032258064515,0
E00126592,133,127,79,48,0,0,1,0,1,5,5,0,0,95.48872180451127,59.3984962406015,36.09022556390977,0,0,0.7518796992481203,0,0.7518796992481203,3.7593984962406015,3.7593984962406015,0,0
E00126593,145,119,61,58,2,2,2,0,2,22,16,6,0,82.06896551724138,42.06896551724138,40,1.3793103448275863,1.3793103448275863,1.3793103448275863,0,1.3793103448275863,15.172413793103448,11.03448275862069,4.137931034482759,0
E00126594,214,177,98,79,2,2,28,5,23,7,5,2,0,82.71028037383178,45.794392523364486,36.915887850467286,0.9345794392523363,0.9345794392523363,13.084112149532709,2.336448598130841,10.74766355140187,3.2710280373831773,2.336448598130841,0.9345794392523363,0
E00126595,126,21,14,7,0,0,16,4,12,89,83,6,0,16.666666666666664,11.11111111111111,5.555555555555555,0,0,12.698412698412698,3.1746031746031744,9.523809523809524,70.63492063492063,65.87301587301587,4.761904761904762,0
E00126596,140,33,21,12,1,1,59,5,54,47,45,2,0,23.57142857142857,15,8.571428571428571,0.7142857142857143,0.7142857142857143,42.142857142857146,3.571428571428571,38.57142857142858,33.57142857142857,32.142857142857146,1.4285714285714286,0
E00126597,166,64,31,33,0,0,20,0,20,82,77,5,0,38.55421686746988,18.67469879518072,19.879518072289155,0,0,12.048192771084338,0,12.048192771084338,49.39759036144578,46.3855421686747,3.0120481927710845,0
E00126598,107,33,20,13,0,0,62,17,45,11,11,0,1,30.8411214953271,18.69158878504673,12.149532710280374,0,0,57.943925233644855,15.887850467289718,42.05607476635514,10.2803738317757,10.2803738317757,0,0.9345794392523363
E00126599,143,67,34,33,0,0,37,10,27,39,37,2,0,46.85314685314685,23.776223776223777,23.076923076923077,0,0,25.874125874125873,6.993006993006993,18.88111888111888,27.27272727272727,25.874125874125873,1.3986013986013985,0
E00126600,139,35,21,14,0,0,91,34,57,13,9,4,0,25.179856115107913,15.107913669064748,10.071942446043165,0,0,65.46762589928058,24.46043165467626,41.007194244604314,9.352517985611511,6.474820143884892,2.877697841726619,0
E00126601,124,67,30,37,2,2,12,2,10,43,40,3,0,54.03225806451613,24.193548387096776,29.838709677419356,1.6129032258064515,1.6129032258064515,9.67741935483871,1.6129032258064515,8.064516129032258,34.67741935483871,32.25806451612903,2.4193548387096775,0
E00126602,130,109,52,57,0,0,18,5,13,3,3,0,0,83.84615384615385,40,43.84615384615385,0,0,13.846153846153847,3.8461538461538463,10,2.307692307692308,2.307692307692308,0,0
E00126604,145,63,31,32,0,0,64,14,50,18,16,2,0,43.44827586206896,21.379310344827587,22.06896551724138,0,0,44.13793103448276,9.655172413793103,34.48275862068966,12.413793103448276,11.03448275862069,1.3793103448275863,0
E00126605,123,85,43,42,5,5,6,0,6,27,23,4,0,69.10569105691057,34.959349593495936,34.146341463414636,4.0650406504065035,4.0650406504065035,4.878048780487805,0,4.878048780487805,21.951219512195124,18.69918699186992,3.2520325203252036,0
E00126607,133,112,51,61,2,2,1,0,1,18,16,2,0,84.21052631578947,38.34586466165413,45.86466165413533,1.5037593984962405,1.5037593984962405,0.7518796992481203,0,0.7518796992481203,13.533834586466165,12.030075187969924,1.5037593984962405,0
E00126608,185,160,46,114,0,0,15,0,15,10,9,1,0,86.48648648648648,24.864864864864867,61.62162162162163,0,0,8.108108108108109,0,8.108108108108109,5.405405405405405,4.864864864864865,0.5405405405405406,0
E00126609,164,122,67,55,6,6,18,1,17,18,16,2,0,74.39024390243902,40.853658536585364,33.53658536585366,3.6585365853658534,3.6585365853658534,10.975609756097562,0.6097560975609756,10.365853658536585,10.975609756097562,9.75609756097561,1.2195121951219512,0
E00126611,150,58,25,33,0,0,31,5,26,61,55,6,0,38.666666666666664,16.666666666666664,22,0,0,20.666666666666668,3.3333333333333335,17.333333333333336,40.666666666666664,36.666666666666664,4,0
E00126612,119,54,32,22,1,1,34,13,21,30,29,1,0,45.378151260504204,26.89075630252101,18.487394957983195,0.8403361344537815,0.8403361344537815,28.57142857142857,10.92436974789916,17.647058823529413,25.210084033613445,24.369747899159663,0.8403361344537815,0
E00126613,136,58,15,43,0,0,46,6,40,32,29,3,0,42.64705882352941,11.029411764705882,31.61764705882353,0,0,33.82352941176471,4.411764705882353,29.411764705882355,23.52941176470588,21.323529411764707,2.2058823529411766,0
E00126614,123,96,34,62,0,0,3,0,3,24,19,5,0,78.04878048780488,27.64227642276423,50.40650406504065,0,0,2.4390243902439024,0,2.4390243902439024,19.51219512195122,15.447154471544716,4.0650406504065035,0
E00126615,134,47,18,29,0,0,62,19,43,25,25,0,0,35.07462686567165,13.432835820895523,21.641791044776117,0,0,46.26865671641791,14.17910447761194,32.08955223880597,18.65671641791045,18.65671641791045,0,0
E00126616,148,124,59,65,0,0,6,1,5,18,18,0,0,83.78378378378379,39.86486486486486,43.91891891891892,0,0,4.054054054054054,0.6756756756756757,3.3783783783783785,12.162162162162163,12.162162162162163,0,0
E00126617,110,23,12,11,0,0,84,35,49,3,3,0,0,20.909090909090907,10.909090909090908,10,0,0,76.36363636363637,31.818181818181817,44.54545454545455,2.727272727272727,2.727272727272727,0,0
E00126618,120,39,22,17,1,1,70,25,45,9,8,1,1,32.5,18.333333333333332,14.166666666666666,0.8333333333333334,0.8333333333333334,58.333333333333336,20.833333333333336,37.5,7.5,6.666666666666667,0.8333333333333334,0.8333333333333334
E00126619,118,38,25,13,0,0,68,24,44,11,10,1,1,32.20338983050847,21.1864406779661,11.016949152542372,0,0,57.6271186440678,20.33898305084746,37.28813559322034,9.322033898305085,8.47457627118644,0.847457627118644,0.847457627118644
E00126620,122,42,16,26,0,0,68,25,43,12,8,4,0,34.42622950819672,13.114754098360656,21.311475409836063,0,0,55.73770491803278,20.491803278688526,35.24590163934426,9.836065573770492,6.557377049180328,3.278688524590164,0
E00126621,136,127,49,78,0,0,2,0,2,7,3,4,0,93.38235294117648,36.029411764705884,57.35294117647059,0,0,1.4705882352941175,0,1.4705882352941175,5.147058823529411,2.2058823529411766,2.941176470588235,0
E00126622,150,122,67,55,0,0,1,1,0,27,22,5,0,81.33333333333333,44.666666666666664,36.666666666666664,0,0,0.6666666666666667,0.6666666666666667,0,18,14.666666666666666,3.3333333333333335,0
E00126623,134,117,58,59,0,0,3,0,3,14,14,0,0,87.31343283582089,43.28358208955223,44.02985074626866,0,0,2.2388059701492535,0,2.2388059701492535,10.44776119402985,10.44776119402985,0,0
E00126624,123,115,54,61,0,0,0,0,0,8,6,2,0,93.4959349593496,43.90243902439025,49.59349593495935,0,0,0,0,0,6.504065040650407,4.878048780487805,1.6260162601626018,0
E00126625,135,115,63,52,1,1,7,0,7,12,11,1,0,85.18518518518519,46.666666666666664,38.51851851851852,0.7407407407407408,0.7407407407407408,5.185185185185185,0,5.185185185185185,8.88888888888889,8.148148148148149,0.7407407407407408,0
E00126626,121,111,60,51,0,0,2,0,2,8,5,3,0,91.73553719008265,49.586776859504134,42.14876033057851,0,0,1.6528925619834711,0,1.6528925619834711,6.6115702479338845,4.132231404958678,2.479338842975207,0
E00126627,114,100,66,34,0,0,4,1,3,10,10,0,0,87.71929824561403,57.89473684210527,29.82456140350877,0,0,3.508771929824561,0.8771929824561403,2.631578947368421,8.771929824561402,8.771929824561402,0,0
E00126628,144,123,67,56,1,1,1,0,1,19,15,4,0,85.41666666666666,46.52777777777778,38.88888888888889,0.6944444444444444,0.6944444444444444,0.6944444444444444,0,0.6944444444444444,13.194444444444445,10.416666666666668,2.7777777777777777,0
E00126629,191,155,57,98,2,2,8,0,8,26,23,3,0,81.15183246073299,29.84293193717277,51.30890052356021,1.0471204188481675,1.0471204188481675,4.18848167539267,0,4.18848167539267,13.612565445026178,12.041884816753926,1.5706806282722512,0
E00126630,125,114,66,48,0,0,1,0,1,10,5,5,0,91.2,52.800000000000004,38.4,0,0,0.8,0,0.8,8,4,4,0
E00126631,124,92,57,35,0,0,27,0,27,5,1,4,0,74.19354838709677,45.96774193548387,28.225806451612907,0,0,21.774193548387096,0,21.774193548387096,4.032258064516129,0.8064516129032258,3.225806451612903,0
E00126632,152,149,78,71,0,0,0,0,0,3,3,0,0,98.02631578947368,51.31578947368421,46.71052631578947,0,0,0,0,0,1.9736842105263157,1.9736842105263157,0,0
E00126633,158,122,55,67,0,0,9,2,7,27,25,2,0,77.21518987341773,34.810126582278485,42.405063291139236,0,0,5.69620253164557,1.2658227848101267,4.430379746835443,17.088607594936708,15.822784810126583,1.2658227848101267,0
E00126634,142,97,45,52,1,1,25,10,15,19,17,2,0,68.30985915492957,31.690140845070424,36.61971830985916,0.7042253521126761,0.7042253521126761,17.6056338028169,7.042253521126761,10.56338028169014,13.380281690140844,11.971830985915492,1.4084507042253522,0
E00126636,139,129,59,70,1,1,2,0,2,7,6,1,0,92.80575539568345,42.44604316546763,50.35971223021583,0.7194244604316548,0.7194244604316548,1.4388489208633095,0,1.4388489208633095,5.0359712230215825,4.316546762589928,0.7194244604316548,0
E00126637,117,102,57,45,1,1,2,0,2,12,9,3,0,87.17948717948718,48.717948717948715,38.46153846153847,0.8547008547008548,0.8547008547008548,1.7094017094017095,0,1.7094017094017095,10.256410256410255,7.6923076923076925,2.564102564102564,0
E00126638,127,125,74,51,0,0,0,0,0,2,2,0,0,98.4251968503937,58.26771653543307,40.15748031496063,0,0,0,0,0,1.574803149606299,1.574803149606299,0,0
E00126639,146,134,65,69,0,0,1,0,1,11,8,3,0,91.78082191780823,44.52054794520548,47.26027397260274,0,0,0.684931506849315,0,0.684931506849315,7.534246575342466,5.47945205479452,2.054794520547945,0
E00126640,131,117,65,52,0,0,4,0,4,10,8,2,0,89.31297709923665,49.61832061068702,39.69465648854962,0,0,3.0534351145038165,0,3.0534351145038165,7.633587786259542,6.106870229007633,1.5267175572519083,0
E00126641,127,93,49,44,1,1,11,1,10,22,16,6,0,73.22834645669292,38.582677165354326,34.645669291338585,0.7874015748031495,0.7874015748031495,8.661417322834646,0.7874015748031495,7.874015748031496,17.322834645669293,12.598425196850393,4.724409448818897,0
E00126642,154,26,12,14,0,0,122,20,102,6,6,0,0,16.883116883116884,7.792207792207792,9.090909090909092,0,0,79.22077922077922,12.987012987012985,66.23376623376623,3.896103896103896,3.896103896103896,0,0
E00126643,176,151,90,61,1,1,2,0,2,22,16,6,0,85.79545454545455,51.13636363636363,34.659090909090914,0.5681818181818182,0.5681818181818182,1.1363636363636365,0,1.1363636363636365,12.5,9.090909090909092,3.4090909090909087,0
E00126644,134,124,58,66,0,0,1,0,1,9,9,0,0,92.53731343283582,43.28358208955223,49.25373134328358,0,0,0.7462686567164178,0,0.7462686567164178,6.7164179104477615,6.7164179104477615,0,0
E00126645,129,119,76,43,2,2,2,1,1,6,6,0,0,92.24806201550388,58.91472868217055,33.33333333333333,1.550387596899225,1.550387596899225,1.550387596899225,0.7751937984496124,0.7751937984496124,4.651162790697675,4.651162790697675,0,0
E00126646,175,113,55,58,0,0,34,0,34,28,21,7,0,64.57142857142857,31.428571428571427,33.14285714285714,0,0,19.428571428571427,0,19.428571428571427,16,12,4,0
E00126647,121,32,11,21,0,0,80,9,71,9,8,1,0,26.446280991735538,9.090909090909092,17.355371900826448,0,0,66.11570247933885,7.43801652892562,58.67768595041323,7.43801652892562,6.6115702479338845,0.8264462809917356,0
E00126648,162,90,33,57,0,0,55,5,50,17,15,2,0,55.55555555555556,20.37037037037037,35.18518518518518,0,0,33.95061728395062,3.0864197530864197,30.864197530864196,10.493827160493826,9.25925925925926,1.2345679012345678,0
E00126649,93,76,54,22,0,0,3,0,3,14,12,2,0,81.72043010752688,58.06451612903226,23.655913978494624,0,0,3.225806451612903,0,3.225806451612903,15.053763440860216,12.903225806451612,2.1505376344086025,0
E00126650,129,12,7,5,1,1,106,11,95,10,9,1,0,9.30232558139535,5.426356589147287,3.875968992248062,0.7751937984496124,0.7751937984496124,82.17054263565892,8.527131782945736,73.64341085271317,7.751937984496124,6.976744186046512,0.7751937984496124,0
E00126651,150,50,17,33,1,1,81,11,70,18,16,2,0,33.33333333333333,11.333333333333332,22,0.6666666666666667,0.6666666666666667,54,7.333333333333333,46.666666666666664,12,10.666666666666668,1.3333333333333335,0
E00126652,94,4,2,2,1,1,76,5,71,13,11,2,0,4.25531914893617,2.127659574468085,2.127659574468085,1.0638297872340425,1.0638297872340425,80.85106382978722,5.319148936170213,75.53191489361703,13.829787234042554,11.702127659574469,2.127659574468085,0
E00126653,151,128,73,55,0,0,1,1,0,22,17,5,0,84.76821192052981,48.34437086092716,36.423841059602644,0,0,0.6622516556291391,0.6622516556291391,0,14.56953642384106,11.258278145695364,3.3112582781456954,0
E00126654,125,31,10,21,2,2,73,3,70,19,16,3,0,24.8,8,16.8,1.6,1.6,58.4,2.4,56.00000000000001,15.2,12.8,2.4,0
E00126655,218,167,99,68,3,3,10,0,10,37,32,5,1,76.60550458715596,45.412844036697244,31.19266055045872,1.3761467889908259,1.3761467889908259,4.587155963302752,0,4.587155963302752,16.972477064220186,14.678899082568808,2.293577981651376,0.45871559633027525
E00126656,106,80,43,37,2,2,2,0,2,22,21,1,0,75.47169811320755,40.56603773584906,34.90566037735849,1.8867924528301887,1.8867924528301887,1.8867924528301887,0,1.8867924528301887,20.754716981132077,19.81132075471698,0.9433962264150944,0
E00126657,114,69,42,27,3,3,7,2,5,35,35,0,0,60.526315789473685,36.84210526315789,23.684210526315788,2.631578947368421,2.631578947368421,6.140350877192982,1.7543859649122806,4.385964912280701,30.701754385964914,30.701754385964914,0,0
E00126658,123,43,23,20,0,0,67,8,59,13,10,3,0,34.959349593495936,18.69918699186992,16.260162601626014,0,0,54.47154471544715,6.504065040650407,47.96747967479675,10.569105691056912,8.130081300813007,2.4390243902439024,0
E00126659,124,12,8,4,0,0,98,8,90,13,12,1,1,9.67741935483871,6.451612903225806,3.225806451612903,0,0,79.03225806451613,6.451612903225806,72.58064516129032,10.483870967741936,9.67741935483871,0.8064516129032258,0.8064516129032258
E00126660,108,101,46,55,0,0,0,0,0,7,6,1,0,93.51851851851852,42.592592592592595,50.92592592592593,0,0,0,0,0,6.481481481481481,5.555555555555555,0.9259259259259258,0
E00126661,118,36,20,16,0,0,72,3,69,10,6,4,0,30.508474576271187,16.94915254237288,13.559322033898304,0,0,61.016949152542374,2.5423728813559325,58.47457627118644,8.47457627118644,5.084745762711865,3.389830508474576,0
E00126662,113,45,17,28,0,0,65,4,61,3,0,3,0,39.823008849557525,15.04424778761062,24.778761061946902,0,0,57.52212389380531,3.5398230088495577,53.98230088495575,2.6548672566371683,0,2.6548672566371683,0
E00126663,113,96,49,47,1,1,0,0,0,16,16,0,0,84.95575221238938,43.36283185840708,41.5929203539823,0.8849557522123894,0.8849557522123894,0,0,0,14.15929203539823,14.15929203539823,0,0
E00126664,121,25,11,14,0,0,85,11,74,11,9,2,0,20.66115702479339,9.090909090909092,11.570247933884298,0,0,70.24793388429752,9.090909090909092,61.15702479338842,9.090909090909092,7.43801652892562,1.6528925619834711,0
E00126666,148,136,96,40,1,1,3,1,2,8,5,3,0,91.8918918918919,64.86486486486487,27.027027027027028,0.6756756756756757,0.6756756756756757,2.027027027027027,0.6756756756756757,1.3513513513513513,5.405405405405405,3.3783783783783785,2.027027027027027,0
E00126667,136,127,81,46,0,0,0,0,0,9,5,4,0,93.38235294117648,59.55882352941176,33.82352941176471,0,0,0,0,0,6.61764705882353,3.6764705882352944,2.941176470588235,0
E00126668,205,62,25,37,0,0,129,7,122,14,10,4,0,30.24390243902439,12.195121951219512,18.048780487804876,0,0,62.926829268292686,3.414634146341464,59.512195121951216,6.829268292682928,4.878048780487805,1.951219512195122,0
E00126669,119,111,60,51,1,1,1,0,1,6,4,2,0,93.27731092436974,50.42016806722689,42.857142857142854,0.8403361344537815,0.8403361344537815,0.8403361344537815,0,0.8403361344537815,5.042016806722689,3.361344537815126,1.680672268907563,0
E00126670,157,151,68,83,0,0,1,0,1,5,4,1,0,96.17834394904459,43.31210191082803,52.86624203821656,0,0,0.6369426751592357,0,0.6369426751592357,3.1847133757961785,2.547770700636943,0.6369426751592357,0
E00126674,107,93,59,34,0,0,0,0,0,14,11,3,0,86.91588785046729,55.140186915887845,31.775700934579437,0,0,0,0,0,13.084112149532709,10.2803738317757,2.803738317757009,0
E00126675,104,82,44,38,0,0,2,1,1,20,15,5,0,78.84615384615384,42.30769230769231,36.53846153846153,0,0,1.9230769230769231,0.9615384615384616,0.9615384615384616,19.230769230769234,14.423076923076922,4.807692307692308,0
E00126676,126,112,65,47,0,0,2,0,2,12,9,3,0,88.88888888888889,51.587301587301596,37.301587301587304,0,0,1.5873015873015872,0,1.5873015873015872,9.523809523809524,7.142857142857142,2.380952380952381,0
E00126677,122,104,41,63,0,0,1,1,0,17,16,1,0,85.24590163934425,33.60655737704918,51.63934426229508,0,0,0.819672131147541,0.819672131147541,0,13.934426229508196,13.114754098360656,0.819672131147541,0
E00126678,128,113,77,36,1,1,0,0,0,14,10,4,0,88.28125,60.15625,28.125,0.78125,0.78125,0,0,0,10.9375,7.8125,3.125,0
E00126679,117,105,65,40,2,2,4,0,4,6,6,0,0,89.74358974358975,55.55555555555556,34.18803418803419,1.7094017094017095,1.7094017094017095,3.418803418803419,0,3.418803418803419,5.128205128205128,5.128205128205128,0,0
E00126680,153,137,89,48,0,0,7,3,4,9,6,3,0,89.54248366013073,58.16993464052288,31.372549019607842,0,0,4.57516339869281,1.9607843137254901,2.6143790849673203,5.88235294117647,3.9215686274509802,1.9607843137254901,0
E00126681,118,112,85,27,0,0,1,0,1,5,5,0,0,94.91525423728814,72.03389830508475,22.88135593220339,0,0,0.847457627118644,0,0.847457627118644,4.23728813559322,4.23728813559322,0,0
E00126682,143,132,66,66,0,0,2,1,1,9,6,3,0,92.3076923076923,46.15384615384615,46.15384615384615,0,0,1.3986013986013985,0.6993006993006993,0.6993006993006993,6.293706293706294,4.195804195804196,2.097902097902098,0
E00126683,117,59,29,30,0,0,17,4,13,41,37,4,0,50.427350427350426,24.786324786324787,25.64102564102564,0,0,14.529914529914532,3.418803418803419,11.11111111111111,35.04273504273504,31.62393162393162,3.418803418803419,0
E00126684,129,111,43,68,0,0,7,3,4,11,9,2,0,86.04651162790698,33.33333333333333,52.71317829457365,0,0,5.426356589147287,2.3255813953488373,3.10077519379845,8.527131782945736,6.976744186046512,1.550387596899225,0
E00126685,133,117,61,56,0,0,1,0,1,15,15,0,0,87.96992481203007,45.86466165413533,42.10526315789473,0,0,0.7518796992481203,0,0.7518796992481203,11.278195488721805,11.278195488721805,0,0
E00126686,131,103,55,48,0,0,15,0,15,13,11,2,0,78.62595419847328,41.98473282442748,36.6412213740458,0,0,11.450381679389313,0,11.450381679389313,9.923664122137405,8.396946564885496,1.5267175572519083,0
E00126687,225,161,46,115,10,10,27,6,21,26,24,2,1,71.55555555555554,20.444444444444446,51.11111111111111,4.444444444444445,4.444444444444445,12,2.666666666666667,9.333333333333334,11.555555555555555,10.666666666666668,0.8888888888888888,0.4444444444444444
E00126688,97,12,7,5,0,0,80,13,67,5,4,1,0,12.371134020618557,7.216494845360824,5.154639175257731,0,0,82.4742268041237,13.402061855670103,69.0721649484536,5.154639175257731,4.123711340206185,1.0309278350515463,0
E00126689,117,96,67,29,0,0,1,0,1,20,17,3,0,82.05128205128204,57.26495726495726,24.786324786324787,0,0,0.8547008547008548,0,0.8547008547008548,17.094017094017094,14.529914529914532,2.564102564102564,0
E00126690,174,141,69,72,1,1,10,2,8,22,20,2,0,81.03448275862068,39.6551724137931,41.37931034482759,0.5747126436781609,0.5747126436781609,5.747126436781609,1.1494252873563218,4.597701149425287,12.643678160919542,11.494252873563218,1.1494252873563218,0
E00126691,192,139,44,95,0,0,35,9,26,18,13,5,0,72.39583333333334,22.916666666666664,49.47916666666667,0,0,18.229166666666664,4.6875,13.541666666666666,9.375,6.770833333333333,2.604166666666667,0
E00126692,147,71,39,32,0,0,8,2,6,68,59,9,0,48.29931972789115,26.53061224489796,21.768707482993197,0,0,5.442176870748299,1.3605442176870748,4.081632653061225,46.25850340136054,40.136054421768705,6.122448979591836,0
E00126693,129,99,65,34,0,0,0,0,0,30,29,1,0,76.74418604651163,50.3875968992248,26.356589147286826,0,0,0,0,0,23.25581395348837,22.48062015503876,0.7751937984496124,0
E00126694,215,131,37,94,9,9,45,8,37,30,29,1,0,60.93023255813953,17.209302325581397,43.72093023255814,4.186046511627907,4.186046511627907,20.930232558139537,3.7209302325581395,17.209302325581397,13.953488372093023,13.488372093023257,0.46511627906976744,0
E00126695,117,34,15,19,0,0,74,18,56,9,8,1,0,29.059829059829063,12.82051282051282,16.23931623931624,0,0,63.24786324786324,15.384615384615385,47.863247863247864,7.6923076923076925,6.837606837606838,0.8547008547008548,0
E00126696,128,108,61,47,0,0,4,2,2,16,15,1,0,84.375,47.65625,36.71875,0,0,3.125,1.5625,1.5625,12.5,11.71875,0.78125,0
E00126697,109,91,45,46,0,0,9,1,8,9,7,2,0,83.4862385321101,41.284403669724774,42.201834862385326,0,0,8.256880733944955,0.9174311926605505,7.339449541284404,8.256880733944955,6.422018348623854,1.834862385321101,0
E00126698,118,100,46,54,0,0,0,0,0,18,16,2,0,84.7457627118644,38.983050847457626,45.76271186440678,0,0,0,0,0,15.254237288135593,13.559322033898304,1.694915254237288,0
E00126699,120,18,6,12,0,0,96,24,72,6,6,0,0,15,5,10,0,0,80,20,60,5,5,0,0
E00126700,128,106,69,37,0,0,3,0,3,19,16,3,0,82.8125,53.90625,28.90625,0,0,2.34375,0,2.34375,14.84375,12.5,2.34375,0
E00126701,136,124,85,39,1,1,0,0,0,11,9,2,0,91.17647058823529,62.5,28.676470588235293,0.7352941176470588,0.7352941176470588,0,0,0,8.088235294117647,6.61764705882353,1.4705882352941175,0
E00126702,198,156,68,88,4,4,20,0,20,18,15,3,0,78.78787878787878,34.34343434343434,44.44444444444444,2.0202020202020203,2.0202020202020203,10.1010101010101,0,10.1010101010101,9.090909090909092,7.575757575757576,1.5151515151515151,0
E00126703,130,117,79,38,0,0,0,0,0,13,11,2,0,90,60.76923076923077,29.230769230769234,0,0,0,0,0,10,8.461538461538462,1.5384615384615385,0
E00126704,167,146,89,57,0,0,2,0,2,19,16,3,0,87.42514970059881,53.293413173652695,34.13173652694611,0,0,1.1976047904191618,0,1.1976047904191618,11.377245508982035,9.580838323353294,1.7964071856287425,0
E00126705,129,107,59,48,0,0,0,0,0,22,20,2,0,82.94573643410853,45.73643410852713,37.2093023255814,0,0,0,0,0,17.05426356589147,15.503875968992247,1.550387596899225,0
E00126706,176,154,74,80,4,4,11,2,9,7,7,0,0,87.5,42.04545454545455,45.45454545454545,2.272727272727273,2.272727272727273,6.25,1.1363636363636365,5.113636363636364,3.977272727272727,3.977272727272727,0,0
E00126707,143,69,36,33,9,9,49,9,40,15,14,1,1,48.25174825174825,25.174825174825177,23.076923076923077,6.293706293706294,6.293706293706294,34.26573426573427,6.293706293706294,27.972027972027973,10.48951048951049,9.79020979020979,0.6993006993006993,0.6993006993006993
E00126708,118,108,66,42,0,0,1,0,1,9,7,2,0,91.52542372881356,55.932203389830505,35.59322033898305,0,0,0.847457627118644,0,0.847457627118644,7.627118644067797,5.932203389830509,1.694915254237288,0
E00126709,129,120,77,43,0,0,0,0,0,9,5,4,0,93.02325581395348,59.68992248062015,33.33333333333333,0,0,0,0,0,6.976744186046512,3.875968992248062,3.10077519379845,0
E00126710,154,105,46,59,13,13,3,0,3,33,32,1,0,68.18181818181817,29.87012987012987,38.311688311688314,8.441558441558442,8.441558441558442,1.948051948051948,0,1.948051948051948,21.428571428571427,20.77922077922078,0.6493506493506493,0
E00126711,112,110,60,50,0,0,0,0,0,2,1,1,0,98.21428571428571,53.57142857142857,44.642857142857146,0,0,0,0,0,1.7857142857142856,0.8928571428571428,0.8928571428571428,0
E00126712,140,113,70,43,0,0,2,0,2,25,22,3,0,80.71428571428572,50,30.714285714285715,0,0,1.4285714285714286,0,1.4285714285714286,17.857142857142858,15.714285714285714,2.142857142857143,0
E00126713,102,97,62,35,0,0,2,0,2,3,1,2,0,95.09803921568627,60.78431372549019,34.31372549019608,0,0,1.9607843137254901,0,1.9607843137254901,2.941176470588235,0.9803921568627451,1.9607843137254901,0
E00126714,110,101,71,30,0,0,1,1,0,8,7,1,0,91.81818181818183,64.54545454545455,27.27272727272727,0,0,0.9090909090909091,0.9090909090909091,0,7.2727272727272725,6.363636363636363,0.9090909090909091,0
E00126715,111,97,55,42,0,0,4,0,4,10,9,1,0,87.38738738738738,49.549549549549546,37.83783783783784,0,0,3.6036036036036037,0,3.6036036036036037,9.00900900900901,8.108108108108109,0.9009009009009009,0
E00126716,117,77,44,33,0,0,30,7,23,10,7,3,0,65.8119658119658,37.60683760683761,28.205128205128204,0,0,25.64102564102564,5.982905982905983,19.65811965811966,8.547008547008547,5.982905982905983,2.564102564102564,0
E00126717,140,127,78,49,0,0,2,0,2,11,8,3,0,90.71428571428571,55.714285714285715,35,0,0,1.4285714285714286,0,1.4285714285714286,7.857142857142857,5.714285714285714,2.142857142857143,0
E00126718,126,106,67,39,1,1,2,0,2,17,17,0,0,84.12698412698413,53.17460317460318,30.952380952380953,0.7936507936507936,0.7936507936507936,1.5873015873015872,0,1.5873015873015872,13.492063492063492,13.492063492063492,0,0
E00126719,158,141,86,55,0,0,1,0,1,16,12,4,0,89.24050632911393,54.43037974683544,34.810126582278485,0,0,0.6329113924050633,0,0.6329113924050633,10.126582278481013,7.59493670886076,2.5316455696202533,0
E00126720,142,113,74,39,0,0,20,8,12,9,7,2,0,79.5774647887324,52.112676056338024,27.464788732394368,0,0,14.084507042253522,5.633802816901409,8.450704225352112,6.338028169014084,4.929577464788732,1.4084507042253522,0
E00126721,108,51,21,30,0,0,49,19,30,8,8,0,0,47.22222222222222,19.444444444444446,27.77777777777778,0,0,45.370370370370374,17.59259259259259,27.77777777777778,7.4074074074074066,7.4074074074074066,0,0
E00126722,119,34,16,18,0,0,76,14,62,9,9,0,0,28.57142857142857,13.445378151260504,15.126050420168067,0,0,63.86554621848739,11.76470588235294,52.10084033613446,7.563025210084033,7.563025210084033,0,0
E00126723,127,90,51,39,10,10,12,2,10,15,11,4,0,70.86614173228347,40.15748031496063,30.708661417322837,7.874015748031496,7.874015748031496,9.448818897637794,1.574803149606299,7.874015748031496,11.811023622047244,8.661417322834646,3.149606299212598,0
E00126724,127,88,51,37,1,1,29,3,26,9,7,2,0,69.29133858267717,40.15748031496063,29.133858267716533,0.7874015748031495,0.7874015748031495,22.83464566929134,2.3622047244094486,20.47244094488189,7.086614173228346,5.511811023622047,1.574803149606299,0
E00126725,77,68,53,15,0,0,0,0,0,9,9,0,0,88.31168831168831,68.83116883116884,19.480519480519483,0,0,0,0,0,11.688311688311687,11.688311688311687,0,0
E00126727,131,129,86,43,1,1,1,0,1,0,0,0,0,98.47328244274809,65.64885496183206,32.82442748091603,0.7633587786259541,0.7633587786259541,0.7633587786259541,0,0.7633587786259541,0,0,0,0
E00126728,123,115,77,38,0,0,1,0,1,7,6,1,0,93.4959349593496,62.601626016260155,30.89430894308943,0,0,0.8130081300813009,0,0.8130081300813009,5.691056910569105,4.878048780487805,0.8130081300813009,0
E00126729,162,129,52,77,0,0,0,0,0,33,30,3,0,79.62962962962963,32.098765432098766,47.53086419753087,0,0,0,0,0,20.37037037037037,18.51851851851852,1.8518518518518516,0
E00126730,108,101,75,26,0,0,1,0,1,6,6,0,0,93.51851851851852,69.44444444444444,24.074074074074073,0,0,0.9259259259259258,0,0.9259259259259258,5.555555555555555,5.555555555555555,0,0
E00126731,121,115,62,53,0,0,1,1,0,5,3,2,0,95.0413223140496,51.2396694214876,43.80165289256198,0,0,0.8264462809917356,0.8264462809917356,0,4.132231404958678,2.479338842975207,1.6528925619834711,0
E00126733,115,101,60,41,0,0,2,1,1,12,10,2,0,87.82608695652175,52.17391304347826,35.65217391304348,0,0,1.7391304347826086,0.8695652173913043,0.8695652173913043,10.434782608695652,8.695652173913043,1.7391304347826086,0
E00126734,115,105,60,45,0,0,0,0,0,10,5,5,0,91.30434782608695,52.17391304347826,39.130434782608695,0,0,0,0,0,8.695652173913043,4.3478260869565215,4.3478260869565215,0
E00126735,134,122,79,43,0,0,1,0,1,11,8,3,0,91.04477611940298,58.95522388059702,32.08955223880597,0,0,0.7462686567164178,0,0.7462686567164178,8.208955223880597,5.970149253731343,2.2388059701492535,0
E00126736,185,166,93,73,1,1,2,1,1,16,11,5,0,89.72972972972974,50.27027027027027,39.45945945945946,0.5405405405405406,0.5405405405405406,1.0810810810810811,0.5405405405405406,0.5405405405405406,8.64864864864865,5.9459459459459465,2.7027027027027026,0
E00126737,120,105,42,63,1,1,0,0,0,14,13,1,0,87.5,35,52.5,0.8333333333333334,0.8333333333333334,0,0,0,11.666666666666666,10.833333333333334,0.8333333333333334,0
E00126738,97,92,56,36,0,0,1,0,1,4,4,0,0,94.84536082474226,57.73195876288659,37.11340206185567,0,0,1.0309278350515463,0,1.0309278350515463,4.123711340206185,4.123711340206185,0,0
E00126739,118,110,61,49,0,0,2,0,2,6,5,1,0,93.22033898305084,51.69491525423729,41.52542372881356,0,0,1.694915254237288,0,1.694915254237288,5.084745762711865,4.23728813559322,0.847457627118644,0
E00126740,103,88,56,32,0,0,1,0,1,14,12,2,0,85.43689320388349,54.36893203883495,31.06796116504854,0,0,0.9708737864077669,0,0.9708737864077669,13.592233009708737,11.650485436893204,1.9417475728155338,0
E00126741,104,101,81,20,0,0,0,0,0,3,2,1,0,97.11538461538461,77.88461538461539,19.230769230769234,0,0,0,0,0,2.8846153846153846,1.9230769230769231,0.9615384615384616,0
E00126742,111,97,48,49,0,0,0,0,0,14,10,4,0,87.38738738738738,43.24324324324324,44.14414414414414,0,0,0,0,0,12.612612612612612,9.00900900900901,3.6036036036036037,0
E00126743,105,101,62,39,0,0,2,1,1,2,2,0,0,96.19047619047619,59.04761904761905,37.142857142857146,0,0,1.9047619047619049,0.9523809523809524,0.9523809523809524,1.9047619047619049,1.9047619047619049,0,0
E00126744,111,95,54,41,2,2,1,0,1,13,10,3,0,85.58558558558559,48.64864864864865,36.93693693693694,1.8018018018018018,1.8018018018018018,0.9009009009009009,0,0.9009009009009009,11.711711711711711,9.00900900900901,2.7027027027027026,0
E00126745,131,80,37,43,0,0,12,3,9,39,38,1,0,61.06870229007634,28.24427480916031,32.82442748091603,0,0,9.16030534351145,2.2900763358778624,6.870229007633588,29.770992366412212,29.00763358778626,0.7633587786259541,0
E00126746,103,100,59,41,0,0,2,0,2,1,1,0,0,97.0873786407767,57.28155339805825,39.80582524271845,0,0,1.9417475728155338,0,1.9417475728155338,0.9708737864077669,0.9708737864077669,0,0
E00126747,108,102,53,49,0,0,2,0,2,4,4,0,0,94.44444444444444,49.074074074074076,45.370370370370374,0,0,1.8518518518518516,0,1.8518518518518516,3.7037037037037033,3.7037037037037033,0,0
E00126749,156,139,71,68,4,4,5,1,4,8,6,2,0,89.1025641025641,45.51282051282051,43.58974358974359,2.564102564102564,2.564102564102564,3.205128205128205,0.641025641025641,2.564102564102564,5.128205128205128,3.8461538461538463,1.282051282051282,0
E00126750,125,74,36,38,7,7,27,7,20,17,17,0,0,59.199999999999996,28.799999999999997,30.4,5.6000000000000005,5.6000000000000005,21.6,5.6000000000000005,16,13.600000000000001,13.600000000000001,0,0
E00126751,128,108,59,49,0,0,1,0,1,19,13,6,0,84.375,46.09375,38.28125,0,0,0.78125,0,0.78125,14.84375,10.15625,4.6875,0
E00126753,122,110,65,45,0,0,1,0,1,11,11,0,0,90.1639344262295,53.278688524590166,36.885245901639344,0,0,0.819672131147541,0,0.819672131147541,9.01639344262295,9.01639344262295,0,0
E00126754,122,111,78,33,1,1,0,0,0,10,8,2,0,90.98360655737704,63.934426229508205,27.049180327868854,0.819672131147541,0.819672131147541,0,0,0,8.19672131147541,6.557377049180328,1.639344262295082,0
E00126756,92,78,50,28,1,1,1,1,0,12,12,0,0,84.78260869565217,54.347826086956516,30.434782608695656,1.0869565217391304,1.0869565217391304,1.0869565217391304,1.0869565217391304,0,13.043478260869565,13.043478260869565,0,0
E00126757,103,79,43,36,0,0,14,3,11,10,7,3,0,76.69902912621359,41.74757281553398,34.95145631067961,0,0,13.592233009708737,2.912621359223301,10.679611650485436,9.70873786407767,6.796116504854369,2.912621359223301,0
E00126758,84,75,52,23,0,0,0,0,0,9,7,2,0,89.28571428571429,61.904761904761905,27.380952380952383,0,0,0,0,0,10.714285714285714,8.333333333333332,2.380952380952381,0
E00126759,180,127,58,69,1,1,19,1,18,33,30,3,0,70.55555555555556,32.22222222222222,38.333333333333336,0.5555555555555556,0.5555555555555556,10.555555555555555,0.5555555555555556,10,18.333333333333332,16.666666666666664,1.6666666666666667,0
E00126760,135,98,53,45,6,6,14,3,11,17,15,2,0,72.5925925925926,39.25925925925926,33.33333333333333,4.444444444444445,4.444444444444445,10.37037037037037,2.2222222222222223,8.148148148148149,12.592592592592592,11.11111111111111,1.4814814814814816,0
E00126761,160,132,70,62,0,0,3,0,3,25,21,4,0,82.5,43.75,38.75,0,0,1.875,0,1.875,15.625,13.125,2.5,0
E00126762,128,110,73,37,0,0,0,0,0,18,14,4,0,85.9375,57.03125,28.90625,0,0,0,0,0,14.0625,10.9375,3.125,0
E00126763,212,152,75,77,6,6,13,3,10,41,37,4,0,71.69811320754717,35.37735849056604,36.32075471698113,2.8301886792452833,2.8301886792452833,6.132075471698113,1.4150943396226416,4.716981132075472,19.339622641509436,17.452830188679243,1.8867924528301887,0
E00126764,121,108,69,39,0,0,0,0,0,13,13,0,0,89.25619834710744,57.02479338842975,32.231404958677686,0,0,0,0,0,10.743801652892563,10.743801652892563,0,0
E00126765,128,103,56,47,0,0,15,1,14,10,8,2,0,80.46875,43.75,36.71875,0,0,11.71875,0.78125,10.9375,7.8125,6.25,1.5625,0
E00126766,124,109,79,30,0,0,1,1,0,14,11,3,0,87.90322580645162,63.70967741935484,24.193548387096776,0,0,0.8064516129032258,0.8064516129032258,0,11.29032258064516,8.870967741935484,2.4193548387096775,0
E00126767,125,45,22,23,2,2,62,9,53,13,9,4,3,36,17.599999999999998,18.4,1.6,1.6,49.6,7.199999999999999,42.4,10.4,7.199999999999999,3.2,2.4
E00126769,179,151,78,73,0,0,3,0,3,25,15,10,0,84.35754189944134,43.575418994413404,40.78212290502793,0,0,1.675977653631285,0,1.675977653631285,13.966480446927374,8.379888268156424,5.58659217877095,0
E00126770,120,108,50,58,0,0,2,1,1,10,9,1,0,90,41.66666666666667,48.333333333333336,0,0,1.6666666666666667,0.8333333333333334,0.8333333333333334,8.333333333333332,7.5,0.8333333333333334,0
E00126771,108,105,46,59,0,0,3,1,2,0,0,0,0,97.22222222222221,42.592592592592595,54.629629629629626,0,0,2.7777777777777777,0.9259259259259258,1.8518518518518516,0,0,0,0
E00126772,174,113,61,52,0,0,48,10,38,13,9,4,0,64.9425287356322,35.05747126436782,29.88505747126437,0,0,27.586206896551722,5.747126436781609,21.839080459770116,7.471264367816093,5.172413793103448,2.2988505747126435,0
E00126774,115,100,70,30,0,0,2,0,2,13,6,7,0,86.95652173913044,60.86956521739131,26.08695652173913,0,0,1.7391304347826086,0,1.7391304347826086,11.304347826086957,5.217391304347826,6.086956521739131,0
E00126775,143,132,74,58,0,0,0,0,0,11,7,4,0,92.3076923076923,51.74825174825175,40.55944055944056,0,0,0,0,0,7.6923076923076925,4.895104895104895,2.797202797202797,0
E00126776,176,135,61,74,8,8,13,3,10,20,13,7,0,76.70454545454545,34.659090909090914,42.04545454545455,4.545454545454546,4.545454545454546,7.386363636363637,1.7045454545454544,5.681818181818182,11.363636363636363,7.386363636363637,3.977272727272727,0
E00126777,109,96,56,40,1,1,1,1,0,11,6,5,0,88.07339449541286,51.37614678899083,36.69724770642202,0.9174311926605505,0.9174311926605505,0.9174311926605505,0.9174311926605505,0,10.091743119266056,5.5045871559633035,4.587155963302752,0
E00126778,143,129,76,53,1,1,1,0,1,12,11,1,0,90.20979020979021,53.14685314685315,37.06293706293706,0.6993006993006993,0.6993006993006993,0.6993006993006993,0,0.6993006993006993,8.391608391608392,7.6923076923076925,0.6993006993006993,0
E00126779,181,140,64,76,0,0,4,0,4,37,29,8,0,77.34806629834254,35.35911602209944,41.988950276243095,0,0,2.209944751381215,0,2.209944751381215,20.441988950276244,16.022099447513813,4.41988950276243,0
E00126780,125,120,70,50,0,0,0,0,0,5,2,3,0,96,56.00000000000001,40,0,0,0,0,0,4,1.6,2.4,0
E00126781,146,105,53,52,0,0,22,0,22,19,15,4,0,71.91780821917808,36.3013698630137,35.61643835616438,0,0,15.068493150684931,0,15.068493150684931,13.013698630136986,10.273972602739725,2.73972602739726,0
E00126782,102,44,22,22,1,1,43,1,42,14,12,2,0,43.13725490196079,21.568627450980394,21.568627450980394,0.9803921568627451,0.9803921568627451,42.15686274509804,0.9803921568627451,41.17647058823529,13.725490196078432,11.76470588235294,1.9607843137254901,0
E00126783,94,82,44,38,0,0,0,0,0,12,10,2,0,87.2340425531915,46.808510638297875,40.42553191489361,0,0,0,0,0,12.76595744680851,10.638297872340425,2.127659574468085,0
E00126784,115,109,69,40,0,0,0,0,0,6,4,2,0,94.78260869565217,60,34.78260869565217,0,0,0,0,0,5.217391304347826,3.4782608695652173,1.7391304347826086,0
E00126785,111,93,56,37,7,7,0,0,0,11,6,5,0,83.78378378378379,50.45045045045045,33.33333333333333,6.306306306306306,6.306306306306306,0,0,0,9.90990990990991,5.405405405405405,4.504504504504505,0
E00126786,119,106,50,56,1,1,1,1,0,11,9,2,0,89.07563025210085,42.016806722689076,47.05882352941176,0.8403361344537815,0.8403361344537815,0.8403361344537815,0.8403361344537815,0,9.243697478991598,7.563025210084033,1.680672268907563,0
E00126787,108,61,38,23,1,1,36,10,26,10,7,3,0,56.481481481481474,35.18518518518518,21.296296296296298,0.9259259259259258,0.9259259259259258,33.33333333333333,9.25925925925926,24.074074074074073,9.25925925925926,6.481481481481481,2.7777777777777777,0
E00126788,121,108,70,38,2,2,0,0,0,11,8,3,0,89.25619834710744,57.85123966942148,31.40495867768595,1.6528925619834711,1.6528925619834711,0,0,0,9.090909090909092,6.6115702479338845,2.479338842975207,0
E00126789,111,81,39,42,0,0,7,0,7,23,22,1,0,72.97297297297297,35.13513513513514,37.83783783783784,0,0,6.306306306306306,0,6.306306306306306,20.72072072072072,19.81981981981982,0.9009009009009009,0
E00126790,173,159,100,59,2,2,2,0,2,10,6,4,0,91.90751445086705,57.80346820809249,34.104046242774565,1.1560693641618496,1.1560693641618496,1.1560693641618496,0,1.1560693641618496,5.780346820809249,3.4682080924855487,2.312138728323699,0
E00170497,118,52,19,33,0,0,16,0,16,50,47,3,0,44.06779661016949,16.101694915254235,27.966101694915253,0,0,13.559322033898304,0,13.559322033898304,42.3728813559322,39.83050847457627,2.5423728813559325,0
E00170498,129,73,20,53,3,3,26,5,21,27,27,0,0,56.58914728682171,15.503875968992247,41.08527131782946,2.3255813953488373,2.3255813953488373,20.155038759689923,3.875968992248062,16.27906976744186,20.930232558139537,20.930232558139537,0,0
E00170499,122,68,19,49,0,0,10,3,7,44,43,1,0,55.73770491803278,15.573770491803279,40.16393442622951,0,0,8.19672131147541,2.459016393442623,5.737704918032787,36.0655737704918,35.24590163934426,0.819672131147541,0
E00170500,129,71,22,49,0,0,47,9,38,11,10,1,0,55.03875968992248,17.05426356589147,37.98449612403101,0,0,36.434108527131784,6.976744186046512,29.457364341085274,8.527131782945736,7.751937984496124,0.7751937984496124,0
E00170501,185,107,22,85,7,7,22,3,19,48,47,1,1,57.83783783783784,11.891891891891893,45.94594594594595,3.783783783783784,3.783783783783784,11.891891891891893,1.6216216216216217,10.27027027027027,25.945945945945947,25.405405405405407,0.5405405405405406,0.5405405405405406
E00170502,126,56,14,42,0,0,13,1,12,57,55,2,0,44.44444444444444,11.11111111111111,33.33333333333333,0,0,10.317460317460316,0.7936507936507936,9.523809523809524,45.23809523809524,43.65079365079365,1.5873015873015872,0
E00170503,165,102,20,82,0,0,10,1,9,53,46,7,0,61.81818181818181,12.121212121212121,49.696969696969695,0,0,6.0606060606060606,0.6060606060606061,5.454545454545454,32.121212121212125,27.878787878787882,4.242424242424243,0
E00170504,139,98,18,80,4,4,26,3,23,11,8,3,0,70.50359712230215,12.949640287769784,57.55395683453237,2.877697841726619,2.877697841726619,18.705035971223023,2.158273381294964,16.546762589928058,7.913669064748201,5.755395683453238,2.158273381294964,0
E00170505,117,86,25,61,0,0,2,1,1,29,27,2,0,73.50427350427351,21.367521367521366,52.13675213675214,0,0,1.7094017094017095,0.8547008547008548,0.8547008547008548,24.786324786324787,23.076923076923077,1.7094017094017095,0
E00170506,118,44,13,31,0,0,45,7,38,29,27,2,0,37.28813559322034,11.016949152542372,26.27118644067797,0,0,38.13559322033898,5.932203389830509,32.20338983050847,24.576271186440678,22.88135593220339,1.694915254237288,0
E00170507,162,83,40,43,2,2,53,7,46,24,22,2,0,51.23456790123457,24.691358024691358,26.543209876543212,1.2345679012345678,1.2345679012345678,32.71604938271605,4.320987654320987,28.39506172839506,14.814814814814813,13.580246913580247,1.2345679012345678,0
E00170508,82,67,27,40,2,2,3,0,3,10,8,2,0,81.70731707317073,32.926829268292686,48.78048780487805,2.4390243902439024,2.4390243902439024,3.6585365853658534,0,3.6585365853658534,12.195121951219512,9.75609756097561,2.4390243902439024,0
E00170510,42,33,14,19,0,0,5,0,5,4,4,0,0,78.57142857142857,33.33333333333333,45.23809523809524,0,0,11.904761904761903,0,11.904761904761903,9.523809523809524,9.523809523809524,0,0
E00170512,127,63,17,46,0,0,4,1,3,60,54,6,0,49.60629921259843,13.385826771653544,36.22047244094488,0,0,3.149606299212598,0.7874015748031495,2.3622047244094486,47.24409448818898,42.51968503937008,4.724409448818897,0
E00170513,88,75,37,38,0,0,1,0,1,12,9,3,0,85.22727272727273,42.04545454545455,43.18181818181818,0,0,1.1363636363636365,0,1.1363636363636365,13.636363636363635,10.227272727272728,3.4090909090909087,0
E00170514,129,118,56,62,0,0,1,0,1,10,8,2,0,91.47286821705426,43.41085271317829,48.06201550387597,0,0,0.7751937984496124,0,0.7751937984496124,7.751937984496124,6.2015503875969,1.550387596899225,0
E00170515,81,71,22,49,0,0,2,0,2,8,7,1,0,87.65432098765432,27.160493827160494,60.49382716049383,0,0,2.4691358024691357,0,2.4691358024691357,9.876543209876543,8.641975308641975,1.2345679012345678,0
E00170518,125,74,37,37,0,0,36,12,24,15,12,3,0,59.199999999999996,29.599999999999998,29.599999999999998,0,0,28.799999999999997,9.6,19.2,12,9.6,2.4,0
E00170519,122,107,38,69,0,0,1,0,1,14,14,0,0,87.70491803278688,31.147540983606557,56.557377049180324,0,0,0.819672131147541,0,0.819672131147541,11.475409836065573,11.475409836065573,0,0
E00170520,122,107,29,78,0,0,2,0,2,13,12,1,0,87.70491803278688,23.770491803278688,63.934426229508205,0,0,1.639344262295082,0,1.639344262295082,10.655737704918032,9.836065573770492,0.819672131147541,0
E00170521,174,153,18,135,0,0,11,2,9,10,8,2,0,87.93103448275862,10.344827586206897,77.58620689655173,0,0,6.321839080459771,1.1494252873563218,5.172413793103448,5.747126436781609,4.597701149425287,1.1494252873563218,0
E00170522,170,122,57,65,2,2,25,3,22,21,16,5,0,71.76470588235294,33.52941176470588,38.23529411764706,1.1764705882352942,1.1764705882352942,14.705882352941178,1.7647058823529411,12.941176470588237,12.352941176470589,9.411764705882353,2.941176470588235,0
E00170523,83,78,45,33,0,0,0,0,0,5,5,0,0,93.97590361445783,54.21686746987952,39.75903614457831,0,0,0,0,0,6.024096385542169,6.024096385542169,0,0
E00181937,248,208,134,74,0,0,2,1,1,38,24,14,0,83.87096774193549,54.03225806451613,29.838709677419356,0,0,0.8064516129032258,0.4032258064516129,0.4032258064516129,15.32258064516129,9.67741935483871,5.64516129032258,0
E00181942,115,86,18,68,5,5,22,1,21,2,1,1,0,74.78260869565217,15.65217391304348,59.130434782608695,4.3478260869565215,4.3478260869565215,19.130434782608695,0.8695652173913043,18.26086956521739,1.7391304347826086,0.8695652173913043,0.8695652173913043,0
E00181945,137,88,16,72,1,1,2,1,1,46,45,1,0,64.23357664233576,11.678832116788321,52.55474452554745,0.7299270072992701,0.7299270072992701,1.4598540145985401,0.7299270072992701,0.7299270072992701,33.57664233576642,32.846715328467155,0.7299270072992701,0
E00181946,108,63,29,34,7,7,28,4,24,10,8,2,0,58.333333333333336,26.851851851851855,31.48148148148148,6.481481481481481,6.481481481481481,25.925925925925924,3.7037037037037033,22.22222222222222,9.25925925925926,7.4074074074074066,1.8518518518518516,0
E00181949,121,120,9,111,0,0,1,0,1,0,0,0,0,99.17355371900827,7.43801652892562,91.73553719008265,0,0,0.8264462809917356,0,0.8264462809917356,0,0,0,0
E00181950,118,90,14,76,0,0,0,0,0,28,25,3,0,76.27118644067797,11.864406779661017,64.40677966101694,0,0,0,0,0,23.728813559322035,21.1864406779661,2.5423728813559325,0
E00181953,161,156,151,5,0,0,3,0,3,2,1,1,0,96.8944099378882,93.7888198757764,3.1055900621118013,0,0,1.8633540372670807,0,1.8633540372670807,1.2422360248447204,0.6211180124223602,0.6211180124223602,0
E00181959,160,148,77,71,0,0,1,1,0,11,10,1,0,92.5,48.125,44.375,0,0,0.625,0.625,0,6.875000000000001,6.25,0.625,0
E00181960,44,35,10,25,0,0,4,1,3,5,5,0,0,79.54545454545455,22.727272727272727,56.81818181818182,0,0,9.090909090909092,2.272727272727273,6.8181818181818175,11.363636363636363,11.363636363636363,0,0
E00181967,188,147,20,127,29,29,8,1,7,4,4,0,0,78.19148936170212,10.638297872340425,67.5531914893617,15.425531914893616,15.425531914893616,4.25531914893617,0.5319148936170213,3.723404255319149,2.127659574468085,2.127659574468085,0,0
E00181970,118,83,8,75,11,11,20,3,17,4,4,0,0,70.33898305084746,6.779661016949152,63.559322033898304,9.322033898305085,9.322033898305085,16.94915254237288,2.5423728813559325,14.40677966101695,3.389830508474576,3.389830508474576,0,0
E00181971,194,176,33,143,0,0,0,0,0,18,14,4,0,90.72164948453609,17.010309278350515,73.71134020618557,0,0,0,0,0,9.278350515463918,7.216494845360824,2.0618556701030926,0
E00181973,175,148,21,127,1,1,15,4,11,11,10,1,0,84.57142857142857,12,72.57142857142857,0.5714285714285714,0.5714285714285714,8.571428571428571,2.2857142857142856,6.2857142857142865,6.2857142857142865,5.714285714285714,0.5714285714285714,0
E00181977,151,124,13,111,9,9,18,2,16,0,0,0,0,82.11920529801324,8.609271523178808,73.50993377483444,5.960264900662252,5.960264900662252,11.920529801324504,1.3245033112582782,10.596026490066226,0,0,0,0
E00181979,248,139,26,113,0,0,15,1,14,94,90,4,0,56.048387096774185,10.483870967741936,45.564516129032256,0,0,6.048387096774194,0.4032258064516129,5.64516129032258,37.903225806451616,36.29032258064516,1.6129032258064515,0
E00181981,147,145,93,52,0,0,0,0,0,2,1,1,0,98.63945578231292,63.26530612244898,35.374149659863946,0,0,0,0,0,1.3605442176870748,0.6802721088435374,0.6802721088435374,0
E00181983,118,112,83,29,1,1,2,0,2,3,3,0,0,94.91525423728814,70.33898305084746,24.576271186440678,0.847457627118644,0.847457627118644,1.694915254237288,0,1.694915254237288,2.5423728813559325,2.5423728813559325,0,0
E00181986,143,60,50,10,0,0,8,0,8,75,65,10,0,41.95804195804196,34.96503496503497,6.993006993006993,0,0,5.594405594405594,0,5.594405594405594,52.44755244755245,45.45454545454545,6.993006993006993,0
E00181987,184,160,25,135,0,0,6,2,4,18,17,1,0,86.95652173913044,13.586956521739129,73.36956521739131,0,0,3.260869565217391,1.0869565217391304,2.1739130434782608,9.782608695652174,9.239130434782608,0.5434782608695652,0
E00181991,68,64,24,40,0,0,2,0,2,2,2,0,0,94.11764705882352,35.294117647058826,58.82352941176471,0,0,2.941176470588235,0,2.941176470588235,2.941176470588235,2.941176470588235,0,0
E00181992,218,179,63,116,5,5,24,4,20,10,10,0,0,82.11009174311926,28.899082568807337,53.21100917431193,2.293577981651376,2.293577981651376,11.009174311926607,1.834862385321101,9.174311926605505,4.587155963302752,4.587155963302752,0,0
E00181994,105,86,18,68,3,3,11,3,8,5,5,0,0,81.9047619047619,17.142857142857142,64.76190476190476,2.857142857142857,2.857142857142857,10.476190476190476,2.857142857142857,7.6190476190476195,4.761904761904762,4.761904761904762,0,0
E00181995,152,146,38,108,0,0,1,1,0,5,5,0,0,96.05263157894737,25,71.05263157894737,0,0,0.6578947368421052,0.6578947368421052,0,3.289473684210526,3.289473684210526,0,0
E00181996,42,26,3,23,0,0,14,1,13,2,2,0,0,61.904761904761905,7.142857142857142,54.761904761904766,0,0,33.33333333333333,2.380952380952381,30.952380952380953,4.761904761904762,4.761904761904762,0,0
E00181999,142,131,70,61,2,2,3,1,2,6,4,2,0,92.25352112676056,49.29577464788733,42.95774647887324,1.4084507042253522,1.4084507042253522,2.112676056338028,0.7042253521126761,1.4084507042253522,4.225352112676056,2.8169014084507045,1.4084507042253522,0
E00182000,75,60,33,27,0,0,3,0,3,12,10,2,0,80,44,36,0,0,4,0,4,16,13.333333333333334,2.666666666666667,0
E00182001,193,121,23,98,0,0,20,1,19,52,48,4,0,62.69430051813472,11.917098445595855,50.77720207253886,0,0,10.362694300518134,0.5181347150259068,9.844559585492227,26.94300518134715,24.870466321243523,2.072538860103627,0
E00182005,112,107,41,66,0,0,2,0,2,3,3,0,0,95.53571428571429,36.607142857142854,58.92857142857143,0,0,1.7857142857142856,0,1.7857142857142856,2.6785714285714284,2.6785714285714284,0,0
E00182008,58,54,16,38,0,0,1,0,1,3,3,0,0,93.10344827586206,27.586206896551722,65.51724137931035,0,0,1.7241379310344827,0,1.7241379310344827,5.172413793103448,5.172413793103448,0,0
E00182012,164,127,8,119,0,0,18,2,16,19,19,0,0,77.4390243902439,4.878048780487805,72.5609756097561,0,0,10.975609756097562,1.2195121951219512,9.75609756097561,11.585365853658537,11.585365853658537,0,0
E00182014,98,77,9,68,0,0,3,0,3,18,17,1,0,78.57142857142857,9.183673469387756,69.38775510204081,0,0,3.061224489795918,0,3.061224489795918,18.367346938775512,17.346938775510203,1.0204081632653061,0
E00182019,65,48,9,39,1,1,3,0,3,13,13,0,0,73.84615384615385,13.846153846153847,60,1.5384615384615385,1.5384615384615385,4.615384615384616,0,4.615384615384616,20,20,0,0
E00182021,102,20,2,18,0,0,70,5,65,12,12,0,0,19.607843137254903,1.9607843137254901,17.647058823529413,0,0,68.62745098039215,4.901960784313726,63.725490196078425,11.76470588235294,11.76470588235294,0,0
E00182024,81,73,14,59,0,0,3,1,2,5,3,2,0,90.12345679012346,17.28395061728395,72.8395061728395,0,0,3.7037037037037033,1.2345679012345678,2.4691358024691357,6.172839506172839,3.7037037037037033,2.4691358024691357,0
E00182026,52,46,9,37,0,0,3,0,3,3,2,1,0,88.46153846153845,17.307692307692307,71.15384615384616,0,0,5.769230769230769,0,5.769230769230769,5.769230769230769,3.8461538461538463,1.9230769230769231,0
E00182030,138,126,21,105,10,10,0,0,0,2,2,0,0,91.30434782608695,15.217391304347828,76.08695652173914,7.246376811594203,7.246376811594203,0,0,0,1.4492753623188406,1.4492753623188406,0,0
E00182033,117,102,19,83,0,0,4,0,4,11,11,0,0,87.17948717948718,16.23931623931624,70.94017094017094,0,0,3.418803418803419,0,3.418803418803419,9.401709401709402,9.401709401709402,0,0
E00182044,155,118,14,104,0,0,24,3,21,13,12,1,0,76.12903225806451,9.032258064516128,67.0967741935484,0,0,15.483870967741936,1.935483870967742,13.548387096774196,8.38709677419355,7.741935483870968,0.6451612903225806,0
