OA,ts0540001,ts0540002,ts0540003,ts0540004,ts0540005,ts0540006,ts0540007,ts0540008,ts0540009,ts0540010,ts0540011,ts0540012,ts0540013,ts0540002_PCT,ts0540003_PCT,ts0540004_PCT,ts0540005_PCT,ts0540006_PCT,ts0540007_PCT,ts0540008_PCT,ts0540009_PCT,ts0540010_PCT,ts0540011_PCT,ts0540012_PCT,ts0540013_PCT
E00155864,119,101,68,33,0,0,1,1,0,17,14,3,0,84.87394957983193,57.14285714285714,27.73109243697479,0,0,0.8403361344537815,0.8403361344537815,0,14.285714285714285,11.76470588235294,2.5210084033613445,0
E00155865,119,69,37,32,8,8,27,7,20,15,10,5,0,57.98319327731093,31.092436974789916,26.89075630252101,6.722689075630252,6.722689075630252,22.689075630252102,5.88235294117647,16.80672268907563,12.605042016806722,8.403361344537815,4.201680672268908,0
E00155866,135,133,69,64,0,0,1,1,0,1,1,0,0,98.51851851851852,51.11111111111111,47.40740740740741,0,0,0.7407407407407408,0.7407407407407408,0,0.7407407407407408,0.7407407407407408,0,0
E00155867,131,130,49,81,0,0,0,0,0,1,1,0,0,99.23664122137404,37.404580152671755,61.832061068702295,0,0,0,0,0,0.7633587786259541,0.7633587786259541,0,0
E00155868,139,90,46,44,3,3,44,1,43,2,2,0,0,64.74820143884892,33.093525179856115,31.654676258992804,2.158273381294964,2.158273381294964,31.654676258992804,0.7194244604316548,30.935251798561154,1.4388489208633095,1.4388489208633095,0,0
E00155869,103,95,56,39,1,1,6,2,4,1,1,0,0,92.23300970873787,54.36893203883495,37.86407766990291,0.9708737864077669,0.9708737864077669,5.825242718446602,1.9417475728155338,3.8834951456310676,0.9708737864077669,0.9708737864077669,0,0
E00155870,124,114,78,36,0,0,0,0,0,10,8,2,0,91.93548387096774,62.903225806451616,29.03225806451613,0,0,0,0,0,8.064516129032258,6.451612903225806,1.6129032258064515,0
E00155871,152,115,44,71,3,3,0,0,0,34,31,3,0,75.6578947368421,28.947368421052634,46.71052631578947,1.9736842105263157,1.9736842105263157,0,0,0,22.36842105263158,20.394736842105264,1.9736842105263157,0
E00155872,144,61,27,34,3,3,60,17,43,20,19,1,0,42.36111111111111,18.75,23.61111111111111,2.083333333333333,2.083333333333333,41.66666666666667,11.805555555555555,29.86111111111111,13.88888888888889,13.194444444444445,0.6944444444444444,0
E00155873,162,135,58,77,1,1,0,0,0,26,25,1,0,83.33333333333334,35.80246913580247,47.53086419753087,0.6172839506172839,0.6172839506172839,0,0,0,16.049382716049383,15.432098765432098,0.6172839506172839,0
E00155875,124,116,66,50,0,0,0,0,0,8,5,3,0,93.54838709677419,53.2258064516129,40.32258064516129,0,0,0,0,0,6.451612903225806,4.032258064516129,2.4193548387096775,0
E00155876,110,108,69,39,1,1,0,0,0,1,1,0,0,98.18181818181819,62.727272727272734,35.45454545454545,0.9090909090909091,0.9090909090909091,0,0,0,0.9090909090909091,0.9090909090909091,0,0
E00155877,113,74,47,27,0,0,31,2,29,8,8,0,0,65.48672566371681,41.5929203539823,23.893805309734514,0,0,27.43362831858407,1.7699115044247788,25.663716814159294,7.079646017699115,7.079646017699115,0,0
E00155878,138,105,56,49,0,0,2,2,0,31,28,3,0,76.08695652173914,40.57971014492754,35.507246376811594,0,0,1.4492753623188406,1.4492753623188406,0,22.463768115942027,20.28985507246377,2.1739130434782608,0
E00155879,141,128,85,43,0,0,4,1,3,9,9,0,0,90.78014184397163,60.28368794326241,30.49645390070922,0,0,2.8368794326241136,0.7092198581560284,2.127659574468085,6.382978723404255,6.382978723404255,0,0
E00155880,113,100,50,50,0,0,6,2,4,7,5,2,0,88.49557522123894,44.24778761061947,44.24778761061947,0,0,5.3097345132743365,1.7699115044247788,3.5398230088495577,6.1946902654867255,4.424778761061947,1.7699115044247788,0
E00155881,110,73,45,28,0,0,15,4,11,22,15,7,0,66.36363636363637,40.909090909090914,25.454545454545453,0,0,13.636363636363635,3.6363636363636362,10,20,13.636363636363635,6.363636363636363,0
E00155882,166,131,98,33,0,0,13,1,12,22,20,2,0,78.91566265060241,59.036144578313255,19.879518072289155,0,0,7.83132530120482,0.6024096385542169,7.228915662650602,13.253012048192772,12.048192771084338,1.2048192771084338,0
E00155883,183,68,31,37,5,5,8,3,5,102,97,5,0,37.15846994535519,16.939890710382514,20.21857923497268,2.73224043715847,2.73224043715847,4.371584699453552,1.639344262295082,2.73224043715847,55.73770491803278,53.00546448087432,2.73224043715847,0
E00155884,134,120,66,54,0,0,3,0,3,11,11,0,0,89.55223880597015,49.25373134328358,40.298507462686565,0,0,2.2388059701492535,0,2.2388059701492535,8.208955223880597,8.208955223880597,0,0
E00155885,133,126,69,57,0,0,1,0,1,6,4,2,0,94.73684210526315,51.8796992481203,42.857142857142854,0,0,0.7518796992481203,0,0.7518796992481203,4.511278195488721,3.007518796992481,1.5037593984962405,0
E00155886,136,101,77,24,0,0,3,1,2,32,29,3,0,74.26470588235294,56.61764705882353,17.647058823529413,0,0,2.2058823529411766,0.7352941176470588,1.4705882352941175,23.52941176470588,21.323529411764707,2.2058823529411766,0
E00155887,133,107,86,21,0,0,3,0,3,23,21,2,0,80.45112781954887,64.66165413533834,15.789473684210526,0,0,2.2556390977443606,0,2.2556390977443606,17.293233082706767,15.789473684210526,1.5037593984962405,0
E00155888,149,133,87,46,0,0,4,1,3,12,10,2,0,89.26174496644296,58.38926174496645,30.87248322147651,0,0,2.684563758389262,0.6711409395973155,2.013422818791946,8.053691275167784,6.7114093959731544,1.342281879194631,0
E00155889,207,177,98,79,3,3,7,0,7,20,16,4,0,85.5072463768116,47.34299516908212,38.164251207729464,1.4492753623188406,1.4492753623188406,3.3816425120772946,0,3.3816425120772946,9.66183574879227,7.729468599033816,1.932367149758454,0
E00155890,127,120,61,59,0,0,0,0,0,7,7,0,0,94.48818897637796,48.031496062992126,46.45669291338583,0,0,0,0,0,5.511811023622047,5.511811023622047,0,0
E00155891,132,117,55,62,4,4,7,2,5,4,3,1,0,88.63636363636364,41.66666666666667,46.96969696969697,3.0303030303030303,3.0303030303030303,5.303030303030303,1.5151515151515151,3.787878787878788,3.0303030303030303,2.272727272727273,0.7575757575757576,0
E00155892,117,71,20,51,0,0,41,6,35,5,5,0,0,60.68376068376068,17.094017094017094,43.58974358974359,0,0,35.04273504273504,5.128205128205128,29.914529914529915,4.273504273504273,4.273504273504273,0,0
E00155893,139,110,46,64,0,0,3,2,1,25,22,3,1,79.13669064748201,33.093525179856115,46.043165467625904,0,0,2.158273381294964,1.4388489208633095,0.7194244604316548,17.985611510791365,15.827338129496402,2.158273381294964,0.7194244604316548
E00155894,136,118,43,75,0,0,0,0,0,18,17,1,0,86.76470588235294,31.61764705882353,55.14705882352941,0,0,0,0,0,13.23529411764706,12.5,0.7352941176470588,0
E00155895,129,122,50,72,0,0,2,0,2,5,4,1,0,94.57364341085271,38.759689922480625,55.81395348837209,0,0,1.550387596899225,0,1.550387596899225,3.875968992248062,3.10077519379845,0.7751937984496124,0
E00155896,124,117,67,50,0,0,2,0,2,5,4,1,0,94.35483870967742,54.03225806451613,40.32258064516129,0,0,1.6129032258064515,0,1.6129032258064515,4.032258064516129,3.225806451612903,0.8064516129032258,0
E00155897,117,80,34,46,0,0,25,1,24,12,11,1,0,68.37606837606837,29.059829059829063,39.31623931623932,0,0,21.367521367521366,0.8547008547008548,20.51282051282051,10.256410256410255,9.401709401709402,0.8547008547008548,0
E00155898,134,106,52,54,0,0,3,0,3,25,21,4,0,79.1044776119403,38.80597014925373,40.298507462686565,0,0,2.2388059701492535,0,2.2388059701492535,18.65671641791045,15.671641791044777,2.9850746268656714,0
E00155899,54,43,30,13,1,1,1,0,1,9,6,3,0,79.62962962962963,55.55555555555556,24.074074074074073,1.8518518518518516,1.8518518518518516,1.8518518518518516,0,1.8518518518518516,16.666666666666664,11.11111111111111,5.555555555555555,0
E00155900,100,100,51,49,0,0,0,0,0,0,0,0,0,100,51,49,0,0,0,0,0,0,0,0,0
E00155901,129,107,62,45,0,0,1,0,1,21,20,1,0,82.94573643410853,48.06201550387597,34.883720930232556,0,0,0.7751937984496124,0,0.7751937984496124,16.27906976744186,15.503875968992247,0.7751937984496124,0
E00155902,126,116,63,53,0,0,1,0,1,9,6,3,0,92.06349206349206,50,42.06349206349206,0,0,0.7936507936507936,0,0.7936507936507936,7.142857142857142,4.761904761904762,2.380952380952381,0
E00155903,148,125,72,53,0,0,9,2,7,14,9,5,0,84.45945945945947,48.64864864864865,35.810810810810814,0,0,6.081081081081082,1.3513513513513513,4.72972972972973,9.45945945945946,6.081081081081082,3.3783783783783785,0
E00155904,135,123,62,61,1,1,3,2,1,8,8,0,0,91.11111111111111,45.925925925925924,45.18518518518518,0.7407407407407408,0.7407407407407408,2.2222222222222223,1.4814814814814816,0.7407407407407408,5.9259259259259265,5.9259259259259265,0,0
E00155906,126,117,74,43,1,1,1,0,1,7,4,3,0,92.85714285714286,58.730158730158735,34.12698412698413,0.7936507936507936,0.7936507936507936,0.7936507936507936,0,0.7936507936507936,5.555555555555555,3.1746031746031744,2.380952380952381,0
E00155907,129,73,32,41,10,10,35,3,32,11,10,1,0,56.58914728682171,24.8062015503876,31.782945736434108,7.751937984496124,7.751937984496124,27.131782945736433,2.3255813953488373,24.8062015503876,8.527131782945736,7.751937984496124,0.7751937984496124,0
E00155908,146,119,76,43,0,0,9,0,9,18,14,4,0,81.5068493150685,52.054794520547944,29.45205479452055,0,0,6.164383561643835,0,6.164383561643835,12.32876712328767,9.58904109589041,2.73972602739726,0
E00155909,142,138,52,86,0,0,0,0,0,4,4,0,0,97.1830985915493,36.61971830985916,60.56338028169014,0,0,0,0,0,2.8169014084507045,2.8169014084507045,0,0
E00155910,137,114,59,55,0,0,16,6,10,7,6,1,0,83.21167883211679,43.06569343065693,40.14598540145985,0,0,11.678832116788321,4.37956204379562,7.2992700729927,5.109489051094891,4.37956204379562,0.7299270072992701,0
E00155911,150,82,26,56,1,1,7,2,5,60,60,0,0,54.666666666666664,17.333333333333336,37.333333333333336,0.6666666666666667,0.6666666666666667,4.666666666666667,1.3333333333333335,3.3333333333333335,40,40,0,0
E00155912,120,87,32,55,0,0,21,7,14,12,10,2,0,72.5,26.666666666666668,45.83333333333333,0,0,17.5,5.833333333333333,11.666666666666666,10,8.333333333333332,1.6666666666666667,0
E00155914,202,60,16,44,0,0,76,2,74,66,56,10,0,29.7029702970297,7.920792079207921,21.782178217821784,0,0,37.62376237623762,0.9900990099009901,36.633663366336634,32.67326732673268,27.722772277227726,4.9504950495049505,0
E00155915,126,53,26,27,0,0,60,9,51,13,11,2,0,42.06349206349206,20.634920634920633,21.428571428571427,0,0,47.61904761904761,7.142857142857142,40.476190476190474,10.317460317460316,8.73015873015873,1.5873015873015872,0
E00155916,126,84,37,47,2,2,33,4,29,7,6,1,0,66.66666666666666,29.365079365079367,37.301587301587304,1.5873015873015872,1.5873015873015872,26.190476190476193,3.1746031746031744,23.015873015873016,5.555555555555555,4.761904761904762,0.7936507936507936,0
E00155917,133,94,25,69,0,0,3,1,2,36,35,1,0,70.67669172932331,18.796992481203006,51.8796992481203,0,0,2.2556390977443606,0.7518796992481203,1.5037593984962405,27.06766917293233,26.31578947368421,0.7518796992481203,0
E00155918,118,91,37,54,0,0,1,0,1,26,22,4,0,77.11864406779661,31.35593220338983,45.76271186440678,0,0,0.847457627118644,0,0.847457627118644,22.033898305084744,18.64406779661017,3.389830508474576,0
E00155919,132,60,31,29,1,1,55,9,46,16,14,2,0,45.45454545454545,23.484848484848484,21.96969696969697,0.7575757575757576,0.7575757575757576,41.66666666666667,6.8181818181818175,34.84848484848485,12.121212121212121,10.606060606060606,1.5151515151515151,0
E00155920,139,101,59,42,1,1,25,3,22,12,10,2,0,72.66187050359713,42.44604316546763,30.215827338129497,0.7194244604316548,0.7194244604316548,17.985611510791365,2.158273381294964,15.827338129496402,8.633093525179856,7.1942446043165464,1.4388489208633095,0
E00155921,122,110,51,59,1,1,4,2,2,7,6,1,0,90.1639344262295,41.80327868852459,48.36065573770492,0.819672131147541,0.819672131147541,3.278688524590164,1.639344262295082,1.639344262295082,5.737704918032787,4.918032786885246,0.819672131147541,0
E00155922,117,102,49,53,2,2,0,0,0,13,12,1,0,87.17948717948718,41.88034188034188,45.2991452991453,1.7094017094017095,1.7094017094017095,0,0,0,11.11111111111111,10.256410256410255,0.8547008547008548,0
E00155923,122,112,42,70,4,4,0,0,0,6,5,1,0,91.80327868852459,34.42622950819672,57.377049180327866,3.278688524590164,3.278688524590164,0,0,0,4.918032786885246,4.098360655737705,0.819672131147541,0
E00155924,129,66,27,39,0,0,28,5,23,35,34,1,0,51.162790697674424,20.930232558139537,30.23255813953488,0,0,21.705426356589147,3.875968992248062,17.829457364341085,27.131782945736433,26.356589147286826,0.7751937984496124,0
E00155925,122,89,23,66,0,0,2,0,2,31,31,0,0,72.95081967213115,18.852459016393443,54.09836065573771,0,0,1.639344262295082,0,1.639344262295082,25.40983606557377,25.40983606557377,0,0
E00155926,129,109,45,64,0,0,2,1,1,18,17,1,0,84.49612403100775,34.883720930232556,49.6124031007752,0,0,1.550387596899225,0.7751937984496124,0.7751937984496124,13.953488372093023,13.178294573643413,0.7751937984496124,0
E00155927,118,94,32,62,1,1,3,0,3,20,19,1,0,79.66101694915254,27.11864406779661,52.54237288135594,0.847457627118644,0.847457627118644,2.5423728813559325,0,2.5423728813559325,16.94915254237288,16.101694915254235,0.847457627118644,0
E00155928,124,99,44,55,0,0,20,5,15,5,4,1,0,79.83870967741935,35.483870967741936,44.354838709677416,0,0,16.129032258064516,4.032258064516129,12.096774193548388,4.032258064516129,3.225806451612903,0.8064516129032258,0
E00155929,151,86,27,59,0,0,13,0,13,52,50,2,0,56.95364238410596,17.880794701986755,39.0728476821192,0,0,8.609271523178808,0,8.609271523178808,34.437086092715234,33.11258278145696,1.3245033112582782,0
E00155930,129,118,96,22,0,0,3,0,3,8,5,3,0,91.47286821705426,74.4186046511628,17.05426356589147,0,0,2.3255813953488373,0,2.3255813953488373,6.2015503875969,3.875968992248062,2.3255813953488373,0
E00155931,126,94,41,53,0,0,15,3,12,17,17,0,0,74.60317460317461,32.53968253968254,42.06349206349206,0,0,11.904761904761903,2.380952380952381,9.523809523809524,13.492063492063492,13.492063492063492,0,0
E00155932,136,87,43,44,1,1,29,3,26,19,12,7,0,63.970588235294116,31.61764705882353,32.35294117647059,0.7352941176470588,0.7352941176470588,21.323529411764707,2.2058823529411766,19.11764705882353,13.970588235294118,8.823529411764707,5.147058823529411,0
E00155933,148,86,32,54,0,0,45,12,33,17,14,3,0,58.108108108108105,21.62162162162162,36.486486486486484,0,0,30.405405405405407,8.108108108108109,22.2972972972973,11.486486486486488,9.45945945945946,2.027027027027027,0
E00155934,139,126,56,70,2,2,2,0,2,9,7,2,0,90.64748201438849,40.28776978417266,50.35971223021583,1.4388489208633095,1.4388489208633095,1.4388489208633095,0,1.4388489208633095,6.474820143884892,5.0359712230215825,1.4388489208633095,0
E00155935,153,109,45,64,1,1,0,0,0,43,41,2,0,71.24183006535948,29.411764705882355,41.830065359477125,0.6535947712418301,0.6535947712418301,0,0,0,28.104575163398692,26.797385620915033,1.3071895424836601,0
E00155936,111,81,38,43,0,0,15,5,10,15,11,4,0,72.97297297297297,34.234234234234236,38.73873873873874,0,0,13.513513513513514,4.504504504504505,9.00900900900901,13.513513513513514,9.90990990990991,3.6036036036036037,0
E00155937,118,101,54,47,0,0,3,0,3,14,11,3,0,85.59322033898306,45.76271186440678,39.83050847457627,0,0,2.5423728813559325,0,2.5423728813559325,11.864406779661017,9.322033898305085,2.5423728813559325,0
E00155938,198,123,64,59,1,1,13,0,13,61,56,5,0,62.121212121212125,32.323232323232325,29.797979797979796,0.5050505050505051,0.5050505050505051,6.565656565656567,0,6.565656565656567,30.808080808080806,28.28282828282828,2.525252525252525,0
E00155940,152,66,25,41,0,0,25,2,23,61,60,1,0,43.42105263157895,16.447368421052634,26.973684210526315,0,0,16.447368421052634,1.3157894736842104,15.131578947368421,40.131578947368425,39.473684210526315,0.6578947368421052,0
E00155941,127,72,39,33,2,2,42,2,40,11,10,1,0,56.69291338582677,30.708661417322837,25.984251968503933,1.574803149606299,1.574803149606299,33.07086614173229,1.574803149606299,31.496062992125985,8.661417322834646,7.874015748031496,0.7874015748031495,0
E00155942,127,68,32,36,1,1,8,2,6,50,50,0,0,53.54330708661418,25.196850393700785,28.346456692913385,0.7874015748031495,0.7874015748031495,6.299212598425196,1.574803149606299,4.724409448818897,39.37007874015748,39.37007874015748,0,0
E00155943,137,126,68,58,0,0,0,0,0,11,10,1,0,91.970802919708035,49.63503649635037,42.33576642335766,0,0,0,0,0,8.02919708029197,7.2992700729927,0.7299270072992701,0
E00155944,120,90,52,38,0,0,20,4,16,10,10,0,0,75,43.333333333333336,31.666666666666664,0,0,16.666666666666664,3.3333333333333335,13.333333333333334,8.333333333333332,8.333333333333332,0,0
E00155945,121,107,72,35,2,2,0,0,0,11,9,2,1,88.42975206611571,59.50413223140496,28.92561983471074,1.6528925619834711,1.6528925619834711,0,0,0,9.090909090909092,7.43801652892562,1.6528925619834711,0.8264462809917356
E00155946,121,41,14,27,0,0,69,8,61,11,10,1,0,33.88429752066116,11.570247933884298,22.31404958677686,0,0,57.02479338842975,6.6115702479338845,50.413223140495866,9.090909090909092,8.264462809917356,0.8264462809917356,0
E00155947,120,73,34,39,0,0,2,0,2,45,37,8,0,60.83333333333333,28.333333333333332,32.5,0,0,1.6666666666666667,0,1.6666666666666667,37.5,30.833333333333336,6.666666666666667,0
E00155948,119,45,29,16,0,0,60,10,50,14,12,2,0,37.81512605042017,24.369747899159663,13.445378151260504,0,0,50.42016806722689,8.403361344537815,42.016806722689076,11.76470588235294,10.084033613445378,1.680672268907563,0
E00155949,135,70,27,43,0,0,50,10,40,15,12,3,0,51.85185185185185,20,31.851851851851855,0,0,37.03703703703704,7.4074074074074066,29.629629629629626,11.11111111111111,8.88888888888889,2.2222222222222223,0
E00155950,114,78,45,33,0,0,10,3,7,26,23,3,0,68.42105263157895,39.473684210526315,28.947368421052634,0,0,8.771929824561402,2.631578947368421,6.140350877192982,22.807017543859647,20.175438596491226,2.631578947368421,0
E00155951,117,66,29,37,0,0,38,9,29,13,11,2,0,56.41025641025641,24.786324786324787,31.62393162393162,0,0,32.47863247863248,7.6923076923076925,24.786324786324787,11.11111111111111,9.401709401709402,1.7094017094017095,0
E00155952,96,91,46,45,0,0,2,1,1,3,1,2,0,94.79166666666666,47.91666666666667,46.875,0,0,2.083333333333333,1.0416666666666665,1.0416666666666665,3.125,1.0416666666666665,2.083333333333333,0
E00155953,153,92,38,54,4,4,5,1,4,52,51,1,0,60.130718954248366,24.836601307189543,35.294117647058826,2.6143790849673203,2.6143790849673203,3.2679738562091507,0.6535947712418301,2.6143790849673203,33.98692810457516,33.33333333333333,0.6535947712418301,0
E00155954,149,114,52,62,4,4,1,0,1,30,27,3,0,76.51006711409396,34.899328859060404,41.61073825503356,2.684563758389262,2.684563758389262,0.6711409395973155,0,0.6711409395973155,20.13422818791946,18.120805369127517,2.013422818791946,0
E00155955,132,120,59,61,1,1,0,0,0,11,11,0,0,90.9090909090909,44.696969696969695,46.21212121212121,0.7575757575757576,0.7575757575757576,0,0,0,8.333333333333332,8.333333333333332,0,0
E00155956,113,60,27,33,0,0,2,0,2,51,45,6,0,53.09734513274337,23.893805309734514,29.20353982300885,0,0,1.7699115044247788,0,1.7699115044247788,45.13274336283185,39.823008849557525,5.3097345132743365,0
E00155957,135,100,43,57,3,3,1,0,1,31,30,1,0,74.07407407407408,31.851851851851855,42.22222222222222,2.2222222222222223,2.2222222222222223,0.7407407407407408,0,0.7407407407407408,22.962962962962962,22.22222222222222,0.7407407407407408,0
E00155958,117,75,33,42,0,0,17,6,11,24,24,0,1,64.1025641025641,28.205128205128204,35.8974358974359,0,0,14.529914529914532,5.128205128205128,9.401709401709402,20.51282051282051,20.51282051282051,0,0.8547008547008548
E00155959,142,102,64,38,0,0,4,1,3,36,31,5,0,71.83098591549296,45.07042253521127,26.76056338028169,0,0,2.8169014084507045,0.7042253521126761,2.112676056338028,25.352112676056336,21.830985915492956,3.5211267605633805,0
E00155961,129,85,53,32,2,2,4,0,4,38,37,1,0,65.89147286821705,41.08527131782946,24.8062015503876,1.550387596899225,1.550387596899225,3.10077519379845,0,3.10077519379845,29.457364341085274,28.68217054263566,0.7751937984496124,0
E00155962,131,60,36,24,0,0,0,0,0,71,62,9,0,45.80152671755725,27.480916030534353,18.3206106870229,0,0,0,0,0,54.19847328244275,47.32824427480916,6.870229007633588,0
E00155963,124,77,44,33,2,2,0,0,0,45,42,3,0,62.096774193548384,35.483870967741936,26.61290322580645,1.6129032258064515,1.6129032258064515,0,0,0,36.29032258064516,33.87096774193548,2.4193548387096775,0
E00155964,129,117,78,39,4,4,0,0,0,8,7,1,0,90.69767441860465,60.46511627906976,30.23255813953488,3.10077519379845,3.10077519379845,0,0,0,6.2015503875969,5.426356589147287,0.7751937984496124,0
E00155965,138,106,39,67,0,0,2,1,1,30,28,2,0,76.81159420289855,28.26086956521739,48.55072463768116,0,0,1.4492753623188406,0.7246376811594203,0.7246376811594203,21.73913043478261,20.28985507246377,1.4492753623188406,0
E00155966,141,118,67,51,4,4,4,1,3,15,12,3,0,83.68794326241135,47.5177304964539,36.17021276595745,2.8368794326241136,2.8368794326241136,2.8368794326241136,0.7092198581560284,2.127659574468085,10.638297872340425,8.51063829787234,2.127659574468085,0
E00155967,156,139,53,86,8,8,6,0,6,3,3,0,0,89.1025641025641,33.97435897435898,55.12820512820513,5.128205128205128,5.128205128205128,3.8461538461538463,0,3.8461538461538463,1.9230769230769231,1.9230769230769231,0,0
E00155968,119,101,40,61,0,0,1,0,1,17,16,1,0,84.87394957983193,33.61344537815126,51.26050420168067,0,0,0.8403361344537815,0,0.8403361344537815,14.285714285714285,13.445378151260504,0.8403361344537815,0
E00155969,139,105,42,63,1,1,15,1,14,18,15,3,0,75.53956834532374,30.215827338129497,45.32374100719424,0.7194244604316548,0.7194244604316548,10.79136690647482,0.7194244604316548,10.071942446043165,12.949640287769784,10.79136690647482,2.158273381294964,0
E00155970,132,129,74,55,0,0,0,0,0,3,3,0,0,97.72727272727273,56.060606060606055,41.66666666666667,0,0,0,0,0,2.272727272727273,2.272727272727273,0,0
E00155971,101,97,52,45,0,0,1,0,1,3,3,0,0,96.03960396039604,51.48514851485149,44.554455445544555,0,0,0.9900990099009901,0,0.9900990099009901,2.9702970297029703,2.9702970297029703,0,0
E00155972,97,91,55,36,0,0,0,0,0,6,5,1,0,93.81443298969072,56.70103092783505,37.11340206185567,0,0,0,0,0,6.185567010309279,5.154639175257731,1.0309278350515463,0
E00155975,106,43,16,27,1,1,2,0,2,60,53,7,0,40.56603773584906,15.09433962264151,25.471698113207548,0.9433962264150944,0.9433962264150944,1.8867924528301887,0,1.8867924528301887,56.60377358490566,50,6.60377358490566,0
E00155976,111,102,51,51,0,0,0,0,0,9,9,0,0,91.8918918918919,45.94594594594595,45.94594594594595,0,0,0,0,0,8.108108108108109,8.108108108108109,0,0
E00155977,112,80,39,41,1,1,0,0,0,31,29,2,0,71.42857142857143,34.82142857142857,36.607142857142854,0.8928571428571428,0.8928571428571428,0,0,0,27.67857142857143,25.892857142857146,1.7857142857142856,0
E00155978,119,55,23,32,1,1,1,0,1,62,59,3,0,46.21848739495798,19.327731092436977,26.89075630252101,0.8403361344537815,0.8403361344537815,0.8403361344537815,0,0.8403361344537815,52.10084033613446,49.57983193277311,2.5210084033613445,0
E00155979,118,73,36,37,0,0,0,0,0,45,44,1,0,61.86440677966102,30.508474576271187,31.35593220338983,0,0,0,0,0,38.13559322033898,37.28813559322034,0.847457627118644,0
E00155980,187,126,51,75,8,8,1,0,1,52,52,0,0,67.37967914438502,27.27272727272727,40.106951871657756,4.27807486631016,4.27807486631016,0.53475935828877,0,0.53475935828877,27.807486631016044,27.807486631016044,0,0
E00155981,124,108,63,45,0,0,1,0,1,15,10,5,0,87.09677419354838,50.806451612903224,36.29032258064516,0,0,0.8064516129032258,0,0.8064516129032258,12.096774193548388,8.064516129032258,4.032258064516129,0
E00155982,124,106,53,53,0,0,4,0,4,14,12,2,0,85.48387096774194,42.74193548387097,42.74193548387097,0,0,3.225806451612903,0,3.225806451612903,11.29032258064516,9.67741935483871,1.6129032258064515,0
E00155983,126,93,52,41,1,1,26,11,15,6,5,1,0,73.80952380952381,41.269841269841265,32.53968253968254,0.7936507936507936,0.7936507936507936,20.634920634920633,8.73015873015873,11.904761904761903,4.761904761904762,3.968253968253968,0.7936507936507936,0
E00155984,136,129,66,63,0,0,2,0,2,5,5,0,0,94.85294117647058,48.529411764705884,46.32352941176471,0,0,1.4705882352941175,0,1.4705882352941175,3.6764705882352944,3.6764705882352944,0,0
E00155985,129,110,47,63,1,1,5,0,5,13,13,0,0,85.27131782945736,36.434108527131784,48.837209302325576,0.7751937984496124,0.7751937984496124,3.875968992248062,0,3.875968992248062,10.077519379844961,10.077519379844961,0,0
E00155986,118,117,77,40,0,0,1,0,1,0,0,0,0,99.15254237288136,65.2542372881356,33.89830508474576,0,0,0.847457627118644,0,0.847457627118644,0,0,0,0
E00155987,116,73,44,29,2,2,25,3,22,16,13,3,0,62.93103448275862,37.93103448275862,25,1.7241379310344827,1.7241379310344827,21.551724137931032,2.586206896551724,18.96551724137931,13.793103448275861,11.206896551724139,2.586206896551724,0
E00155988,124,54,36,18,0,0,54,11,43,15,11,4,1,43.54838709677419,29.03225806451613,14.516129032258066,0,0,43.54838709677419,8.870967741935484,34.67741935483871,12.096774193548388,8.870967741935484,3.225806451612903,0.8064516129032258
E00155989,125,45,18,27,0,0,67,11,56,13,13,0,0,36,14.399999999999999,21.6,0,0,53.6,8.799999999999999,44.800000000000004,10.4,10.4,0,0
E00155990,124,30,9,21,0,0,88,14,74,6,6,0,0,24.193548387096776,7.258064516129033,16.93548387096774,0,0,70.96774193548387,11.29032258064516,59.67741935483871,4.838709677419355,4.838709677419355,0,0
E00155991,116,59,32,27,0,0,40,10,30,17,15,2,0,50.86206896551724,27.586206896551722,23.275862068965516,0,0,34.48275862068966,8.620689655172415,25.862068965517242,14.655172413793101,12.931034482758621,1.7241379310344827,0
E00155992,117,100,50,50,1,1,2,0,2,14,9,5,0,85.47008547008546,42.73504273504273,42.73504273504273,0.8547008547008548,0.8547008547008548,1.7094017094017095,0,1.7094017094017095,11.965811965811966,7.6923076923076925,4.273504273504273,0
E00155993,123,99,56,43,3,3,1,0,1,20,18,2,0,80.48780487804879,45.52845528455284,34.959349593495936,2.4390243902439024,2.4390243902439024,0.8130081300813009,0,0.8130081300813009,16.260162601626014,14.634146341463413,1.6260162601626018,0
E00155994,119,101,62,39,0,0,1,0,1,17,17,0,0,84.87394957983193,52.10084033613446,32.773109243697476,0,0,0.8403361344537815,0,0.8403361344537815,14.285714285714285,14.285714285714285,0,0
E00155996,135,127,67,60,1,1,0,0,0,7,6,1,0,94.07407407407408,49.629629629629626,44.44444444444444,0.7407407407407408,0.7407407407407408,0,0,0,5.185185185185185,4.444444444444445,0.7407407407407408,0
E00155997,125,115,76,39,0,0,0,0,0,10,9,1,0,92,60.8,31.2,0,0,0,0,0,8,7.199999999999999,0.8,0
E00155998,151,59,14,45,0,0,83,8,75,9,7,2,0,39.0728476821192,9.271523178807946,29.80132450331126,0,0,54.966887417218544,5.298013245033113,49.668874172185426,5.960264900662252,4.635761589403973,1.3245033112582782,0
E00155999,126,89,51,38,2,2,21,8,13,14,14,0,0,70.63492063492063,40.476190476190474,30.158730158730158,1.5873015873015872,1.5873015873015872,16.666666666666664,6.349206349206349,10.317460317460316,11.11111111111111,11.11111111111111,0,0
E00156000,119,62,29,33,0,0,47,14,33,10,8,2,0,52.10084033613446,24.369747899159663,27.73109243697479,0,0,39.49579831932773,11.76470588235294,27.73109243697479,8.403361344537815,6.722689075630252,1.680672268907563,0
E00156001,132,99,54,45,0,0,17,5,12,16,15,1,0,75,40.909090909090914,34.090909090909086,0,0,12.878787878787879,3.787878787878788,9.090909090909092,12.121212121212121,11.363636363636363,0.7575757575757576,0
E00156002,123,91,45,46,0,0,14,1,13,18,17,1,0,73.98373983739837,36.58536585365854,37.39837398373984,0,0,11.38211382113821,0.8130081300813009,10.569105691056912,14.634146341463413,13.821138211382115,0.8130081300813009,0
E00156003,171,108,48,60,25,25,26,1,25,12,9,3,0,63.1578947368421,28.07017543859649,35.08771929824561,14.619883040935672,14.619883040935672,15.204678362573098,0.5847953216374269,14.619883040935672,7.017543859649122,5.263157894736842,1.7543859649122806,0
E00156004,138,115,50,65,0,0,5,0,5,18,13,5,0,83.33333333333334,36.231884057971016,47.10144927536232,0,0,3.6231884057971016,0,3.6231884057971016,13.043478260869565,9.420289855072465,3.6231884057971016,0
E00156005,156,120,52,68,0,0,14,3,11,22,18,4,0,76.92307692307693,33.33333333333333,43.58974358974359,0,0,8.974358974358974,1.9230769230769231,7.051282051282051,14.102564102564102,11.538461538461538,2.564102564102564,0
E00156006,119,86,45,41,0,0,11,3,8,22,21,1,0,72.26890756302521,37.81512605042017,34.45378151260504,0,0,9.243697478991598,2.5210084033613445,6.722689075630252,18.487394957983195,17.647058823529413,0.8403361344537815,0
E00156007,115,50,14,36,0,0,39,7,32,26,21,5,0,43.47826086956522,12.173913043478262,31.30434782608696,0,0,33.91304347826087,6.086956521739131,27.82608695652174,22.608695652173914,18.26086956521739,4.3478260869565215,0
E00156008,138,127,79,48,0,0,3,0,3,8,6,2,0,92.02898550724638,57.2463768115942,34.78260869565217,0,0,2.1739130434782608,0,2.1739130434782608,5.797101449275362,4.3478260869565215,1.4492753623188406,0
E00156009,114,107,49,58,0,0,1,0,1,6,5,1,0,93.85964912280701,42.98245614035088,50.877192982456144,0,0,0.8771929824561403,0,0.8771929824561403,5.263157894736842,4.385964912280701,0.8771929824561403,0
E00156012,131,111,56,55,0,0,1,0,1,19,16,3,0,84.7328244274809,42.74809160305343,41.98473282442748,0,0,0.7633587786259541,0,0.7633587786259541,14.50381679389313,12.213740458015266,2.2900763358778624,0
E00156013,151,138,68,70,0,0,2,1,1,11,9,2,0,91.3907284768212,45.033112582781456,46.35761589403973,0,0,1.3245033112582782,0.6622516556291391,0.6622516556291391,7.28476821192053,5.960264900662252,1.3245033112582782,0
E00156014,131,122,58,64,0,0,0,0,0,9,9,0,0,93.12977099236642,44.274809160305345,48.854961832061065,0,0,0,0,0,6.870229007633588,6.870229007633588,0,0
E00156015,133,71,35,36,5,5,42,9,33,15,11,4,0,53.383458646616546,26.31578947368421,27.06766917293233,3.7593984962406015,3.7593984962406015,31.57894736842105,6.7669172932330826,24.81203007518797,11.278195488721805,8.270676691729323,3.007518796992481,0
E00156016,163,138,66,72,0,0,13,0,13,12,10,2,0,84.66257668711657,40.49079754601227,44.171779141104295,0,0,7.975460122699387,0,7.975460122699387,7.361963190184049,6.134969325153374,1.2269938650306749,0
E00156017,164,146,58,88,0,0,2,0,2,16,14,2,0,89.02439024390245,35.36585365853659,53.65853658536586,0,0,1.2195121951219512,0,1.2195121951219512,9.75609756097561,8.536585365853659,1.2195121951219512,0
E00156018,131,114,57,57,0,0,1,0,1,16,14,2,0,87.02290076335878,43.51145038167939,43.51145038167939,0,0,0.7633587786259541,0,0.7633587786259541,12.213740458015266,10.687022900763358,1.5267175572519083,0
E00156019,227,181,85,96,0,0,0,0,0,46,41,5,0,79.73568281938326,37.44493392070485,42.290748898678416,0,0,0,0,0,20.26431718061674,18.06167400881057,2.2026431718061676,0
E00156020,126,108,61,47,1,1,12,1,11,5,5,0,0,85.71428571428571,48.41269841269841,37.301587301587304,0.7936507936507936,0.7936507936507936,9.523809523809524,0.7936507936507936,8.73015873015873,3.968253968253968,3.968253968253968,0,0
E00156021,201,156,93,63,5,5,1,0,1,39,32,7,0,77.61194029850746,46.26865671641791,31.343283582089555,2.4875621890547266,2.4875621890547266,0.4975124378109453,0,0.4975124378109453,19.402985074626866,15.92039800995025,3.482587064676617,0
E00156022,130,120,64,56,0,0,0,0,0,10,9,1,0,92.3076923076923,49.23076923076923,43.07692307692308,0,0,0,0,0,7.6923076923076925,6.923076923076923,0.7692307692307693,0
E00156023,146,114,60,54,0,0,1,0,1,31,30,1,0,78.08219178082192,41.0958904109589,36.986301369863014,0,0,0.684931506849315,0,0.684931506849315,21.232876712328768,20.54794520547945,0.684931506849315,0
E00156024,150,143,76,67,0,0,1,1,0,6,5,1,0,95.33333333333334,50.66666666666667,44.666666666666664,0,0,0.6666666666666667,0.6666666666666667,0,4,3.3333333333333335,0.6666666666666667,0
E00156025,123,110,62,48,0,0,1,0,1,12,9,3,0,89.43089430894308,50.40650406504065,39.02439024390244,0,0,0.8130081300813009,0,0.8130081300813009,9.75609756097561,7.317073170731707,2.4390243902439024,0
E00156026,150,130,64,66,1,1,0,0,0,19,17,2,0,86.66666666666667,42.66666666666667,44,0.6666666666666667,0.6666666666666667,0,0,0,12.666666666666668,11.333333333333332,1.3333333333333335,0
E00156027,132,76,34,42,0,0,38,2,36,18,18,0,0,57.57575757575758,25.757575757575758,31.818181818181817,0,0,28.78787878787879,1.5151515151515151,27.27272727272727,13.636363636363635,13.636363636363635,0,0
E00156028,125,108,51,57,1,1,3,0,3,13,10,3,0,86.4,40.8,45.6,0.8,0.8,2.4,0,2.4,10.4,8,2.4,0
E00156029,139,78,30,48,3,3,1,0,1,57,54,3,0,56.11510791366906,21.58273381294964,34.53237410071942,2.158273381294964,2.158273381294964,0.7194244604316548,0,0.7194244604316548,41.007194244604314,38.84892086330935,2.158273381294964,0
E00156030,131,118,34,84,0,0,2,1,1,11,9,2,0,90.07633587786259,25.954198473282442,64.12213740458014,0,0,1.5267175572519083,0.7633587786259541,0.7633587786259541,8.396946564885496,6.870229007633588,1.5267175572519083,0
E00156031,142,109,32,77,0,0,1,0,1,32,29,3,0,76.76056338028168,22.535211267605636,54.22535211267606,0,0,0.7042253521126761,0,0.7042253521126761,22.535211267605636,20.422535211267608,2.112676056338028,0
E00156032,132,108,51,57,0,0,1,0,1,23,15,8,0,81.81818181818183,38.63636363636363,43.18181818181818,0,0,0.7575757575757576,0,0.7575757575757576,17.424242424242426,11.363636363636363,6.0606060606060606,0
E00156033,142,129,73,56,8,8,1,0,1,4,3,1,0,90.84507042253522,51.40845070422535,39.436619718309856,5.633802816901409,5.633802816901409,0.7042253521126761,0,0.7042253521126761,2.8169014084507045,2.112676056338028,0.7042253521126761,0
E00156034,124,113,52,61,0,0,3,0,3,8,7,1,0,91.12903225806451,41.935483870967744,49.193548387096776,0,0,2.4193548387096775,0,2.4193548387096775,6.451612903225806,5.64516129032258,0.8064516129032258,0
E00156035,129,112,31,81,0,0,2,1,1,15,12,3,0,86.82170542635659,24.031007751937985,62.7906976744186,0,0,1.550387596899225,0.7751937984496124,0.7751937984496124,11.627906976744185,9.30232558139535,2.3255813953488373,0
E00156036,119,60,19,41,0,0,32,5,27,27,24,3,0,50.42016806722689,15.966386554621847,34.45378151260504,0,0,26.89075630252101,4.201680672268908,22.689075630252102,22.689075630252102,20.168067226890756,2.5210084033613445,0
E00156037,114,91,28,63,0,0,14,0,14,9,7,2,0,79.82456140350878,24.561403508771928,55.26315789473685,0,0,12.280701754385964,0,12.280701754385964,7.894736842105263,6.140350877192982,1.7543859649122806,0
E00156038,128,114,42,72,1,1,5,1,4,8,8,0,0,89.0625,32.8125,56.25,0.78125,0.78125,3.90625,0.78125,3.125,6.25,6.25,0,0
E00156039,133,125,62,63,0,0,1,0,1,7,7,0,0,93.98496240601504,46.616541353383454,47.368421052631575,0,0,0.7518796992481203,0,0.7518796992481203,5.263157894736842,5.263157894736842,0,0
E00156040,119,89,38,51,3,3,2,0,2,25,23,2,0,74.78991596638656,31.932773109243694,42.857142857142854,2.5210084033613445,2.5210084033613445,1.680672268907563,0,1.680672268907563,21.008403361344538,19.327731092436977,1.680672268907563,0
E00156041,174,51,23,28,1,1,98,10,88,24,22,2,0,29.310344827586203,13.218390804597702,16.091954022988507,0.5747126436781609,0.5747126436781609,56.32183908045977,5.747126436781609,50.57471264367817,13.793103448275861,12.643678160919542,1.1494252873563218,0
E00156042,134,97,40,57,0,0,9,2,7,28,28,0,0,72.38805970149254,29.850746268656714,42.53731343283582,0,0,6.7164179104477615,1.4925373134328357,5.223880597014925,20.8955223880597,20.8955223880597,0,0
E00156043,111,107,57,50,0,0,0,0,0,4,4,0,0,96.3963963963964,51.35135135135135,45.04504504504504,0,0,0,0,0,3.6036036036036037,3.6036036036036037,0,0
E00156044,126,104,41,63,0,0,7,0,7,15,14,1,0,82.53968253968253,32.53968253968254,50,0,0,5.555555555555555,0,5.555555555555555,11.904761904761903,11.11111111111111,0.7936507936507936,0
E00156045,158,70,33,37,12,12,63,11,52,13,11,2,0,44.303797468354425,20.88607594936709,23.417721518987342,7.59493670886076,7.59493670886076,39.87341772151899,6.962025316455696,32.91139240506329,8.227848101265822,6.962025316455696,1.2658227848101267,0
E00156046,126,86,37,49,0,0,20,3,17,20,18,2,0,68.25396825396825,29.365079365079367,38.88888888888889,0,0,15.873015873015872,2.380952380952381,13.492063492063492,15.873015873015872,14.285714285714285,1.5873015873015872,0
E00156047,128,61,17,44,5,5,54,5,49,8,6,2,0,47.65625,13.28125,34.375,3.90625,3.90625,42.1875,3.90625,38.28125,6.25,4.6875,1.5625,0
E00156048,133,96,50,46,0,0,27,4,23,10,8,2,0,72.18045112781954,37.59398496240601,34.58646616541353,0,0,20.30075187969925,3.007518796992481,17.293233082706767,7.518796992481203,6.015037593984962,1.5037593984962405,0
E00156049,140,132,68,64,1,1,1,0,1,6,5,1,0,94.28571428571428,48.57142857142857,45.714285714285715,0.7142857142857143,0.7142857142857143,0.7142857142857143,0,0.7142857142857143,4.285714285714286,3.571428571428571,0.7142857142857143,0
E00156050,132,108,41,67,0,0,3,0,3,21,19,2,0,81.81818181818183,31.060606060606062,50.75757575757576,0,0,2.272727272727273,0,2.272727272727273,15.909090909090908,14.393939393939394,1.5151515151515151,0
E00156051,130,96,43,53,0,0,1,1,0,33,32,1,0,73.84615384615385,33.07692307692307,40.76923076923077,0,0,0.7692307692307693,0.7692307692307693,0,25.384615384615383,24.615384615384617,0.7692307692307693,0
E00156052,110,76,32,44,0,0,29,7,22,5,5,0,0,69.0909090909091,29.09090909090909,40,0,0,26.36363636363636,6.363636363636363,20,4.545454545454546,4.545454545454546,0,0
E00156053,133,102,34,68,0,0,17,4,13,14,11,3,0,76.69172932330827,25.563909774436087,51.127819548872175,0,0,12.781954887218044,3.007518796992481,9.774436090225564,10.526315789473683,8.270676691729323,2.2556390977443606,0
E00156054,139,118,46,72,1,1,6,0,6,14,12,2,0,84.89208633093526,33.093525179856115,51.798561151079134,0.7194244604316548,0.7194244604316548,4.316546762589928,0,4.316546762589928,10.071942446043165,8.633093525179856,1.4388489208633095,0
E00156055,144,127,60,67,1,1,6,1,5,10,9,1,0,88.19444444444444,41.66666666666667,46.52777777777778,0.6944444444444444,0.6944444444444444,4.166666666666666,0.6944444444444444,3.4722222222222223,6.944444444444445,6.25,0.6944444444444444,0
E00156056,164,128,54,74,4,4,10,1,9,22,22,0,0,78.04878048780488,32.926829268292686,45.1219512195122,2.4390243902439024,2.4390243902439024,6.097560975609756,0.6097560975609756,5.487804878048781,13.414634146341465,13.414634146341465,0,0
E00156057,160,62,19,43,4,4,83,22,61,11,8,3,0,38.75,11.875,26.875,2.5,2.5,51.87500000000001,13.750000000000002,38.125,6.875000000000001,5,1.875,0
E00156058,107,95,40,55,0,0,0,0,0,12,10,2,0,88.78504672897196,37.38317757009346,51.4018691588785,0,0,0,0,0,11.214953271028037,9.345794392523365,1.8691588785046727,0
E00156059,114,66,21,45,1,1,29,6,23,18,12,6,0,57.89473684210527,18.421052631578945,39.473684210526315,0.8771929824561403,0.8771929824561403,25.438596491228072,5.263157894736842,20.175438596491226,15.789473684210526,10.526315789473683,5.263157894736842,0
E00156060,125,38,4,34,3,3,72,12,60,12,12,0,0,30.4,3.2,27.200000000000003,2.4,2.4,57.599999999999994,9.6,48,9.6,9.6,0,0
E00156061,121,57,16,41,1,1,61,14,47,2,2,0,0,47.107438016528924,13.223140495867769,33.88429752066116,0.8264462809917356,0.8264462809917356,50.413223140495866,11.570247933884298,38.84297520661157,1.6528925619834711,1.6528925619834711,0,0
E00156062,121,74,22,52,0,0,36,15,21,11,10,1,0,61.15702479338842,18.181818181818183,42.97520661157025,0,0,29.75206611570248,12.396694214876034,17.355371900826448,9.090909090909092,8.264462809917356,0.8264462809917356,0
E00156063,148,85,35,50,0,0,3,1,2,60,56,4,0,57.432432432432435,23.64864864864865,33.78378378378378,0,0,2.027027027027027,0.6756756756756757,1.3513513513513513,40.54054054054054,37.83783783783784,2.7027027027027026,0
E00156064,136,124,72,52,0,0,2,1,1,10,10,0,0,91.17647058823529,52.94117647058824,38.23529411764706,0,0,1.4705882352941175,0.7352941176470588,0.7352941176470588,7.352941176470589,7.352941176470589,0,0
E00156065,139,128,62,66,0,0,2,0,2,9,8,1,0,92.08633093525181,44.60431654676259,47.482014388489205,0,0,1.4388489208633095,0,1.4388489208633095,6.474820143884892,5.755395683453238,0.7194244604316548,0
E00156066,113,55,25,30,1,1,41,11,30,16,13,3,0,48.67256637168141,22.123893805309734,26.548672566371685,0.8849557522123894,0.8849557522123894,36.283185840707965,9.734513274336283,26.548672566371685,14.15929203539823,11.504424778761061,2.6548672566371683,0
E00156067,147,111,57,54,0,0,3,0,3,33,29,4,0,75.51020408163265,38.775510204081634,36.734693877551024,0,0,2.0408163265306123,0,2.0408163265306123,22.448979591836736,19.727891156462583,2.7210884353741496,0
E00156068,125,69,25,44,1,1,19,4,15,36,31,5,0,55.2,20,35.199999999999996,0.8,0.8,15.2,3.2,12,28.799999999999997,24.8,4,0
E00156069,153,57,17,40,0,0,43,2,41,53,50,3,0,37.254901960784316,11.11111111111111,26.143790849673206,0,0,28.104575163398692,1.3071895424836601,26.797385620915033,34.64052287581699,32.6797385620915,1.9607843137254901,0
E00156070,132,48,19,29,8,8,67,10,57,9,8,1,0,36.36363636363637,14.393939393939394,21.96969696969697,6.0606060606060606,6.0606060606060606,50.75757575757576,7.575757575757576,43.18181818181818,6.8181818181818175,6.0606060606060606,0.7575757575757576,0
E00156071,122,87,27,60,0,0,31,4,27,4,3,1,0,71.31147540983606,22.131147540983605,49.18032786885246,0,0,25.40983606557377,3.278688524590164,22.131147540983605,3.278688524590164,2.459016393442623,0.819672131147541,0
E00156072,126,84,33,51,1,1,32,7,25,9,7,2,0,66.66666666666666,26.190476190476193,40.476190476190474,0.7936507936507936,0.7936507936507936,25.396825396825395,5.555555555555555,19.841269841269842,7.142857142857142,5.555555555555555,1.5873015873015872,0
E00156073,166,52,19,33,26,26,83,22,61,5,5,0,0,31.32530120481928,11.44578313253012,19.879518072289155,15.66265060240964,15.66265060240964,50,13.253012048192772,36.74698795180723,3.0120481927710845,3.0120481927710845,0,0
E00156074,124,80,29,51,0,0,35,5,30,9,7,2,0,64.51612903225806,23.387096774193548,41.12903225806452,0,0,28.225806451612907,4.032258064516129,24.193548387096776,7.258064516129033,5.64516129032258,1.6129032258064515,0
E00156075,140,106,41,65,3,3,25,4,21,6,6,0,0,75.71428571428571,29.28571428571429,46.42857142857143,2.142857142857143,2.142857142857143,17.857142857142858,2.857142857142857,15,4.285714285714286,4.285714285714286,0,0
E00156076,118,66,44,22,0,0,49,0,49,3,2,1,0,55.932203389830505,37.28813559322034,18.64406779661017,0,0,41.52542372881356,0,41.52542372881356,2.5423728813559325,1.694915254237288,0.847457627118644,0
E00156077,147,136,70,66,0,0,3,1,2,8,7,1,0,92.51700680272108,47.61904761904761,44.89795918367347,0,0,2.0408163265306123,0.6802721088435374,1.3605442176870748,5.442176870748299,4.761904761904762,0.6802721088435374,0
E00156078,132,119,57,62,0,0,12,3,9,1,0,1,0,90.15151515151516,43.18181818181818,46.96969696969697,0,0,9.090909090909092,2.272727272727273,6.8181818181818175,0.7575757575757576,0,0.7575757575757576,0
E00156079,133,131,59,72,0,0,0,0,0,2,2,0,0,98.49624060150376,44.3609022556391,54.13533834586466,0,0,0,0,0,1.5037593984962405,1.5037593984962405,0,0
E00156080,132,120,63,57,0,0,2,0,2,10,9,1,0,90.9090909090909,47.72727272727273,43.18181818181818,0,0,1.5151515151515151,0,1.5151515151515151,7.575757575757576,6.8181818181818175,0.7575757575757576,0
E00156081,150,141,65,76,3,3,0,0,0,6,5,1,0,94,43.333333333333336,50.66666666666667,2,2,0,0,0,4,3.3333333333333335,0.6666666666666667,0
E00156082,144,127,52,75,0,0,6,0,6,11,11,0,0,88.19444444444444,36.11111111111111,52.083333333333336,0,0,4.166666666666666,0,4.166666666666666,7.638888888888889,7.638888888888889,0,0
E00156083,133,130,84,46,1,1,2,1,1,0,0,0,0,97.74436090225564,63.1578947368421,34.58646616541353,0.7518796992481203,0.7518796992481203,1.5037593984962405,0.7518796992481203,0.7518796992481203,0,0,0,0
E00156084,143,116,39,77,1,1,16,2,14,10,9,1,0,81.11888111888112,27.27272727272727,53.84615384615385,0.6993006993006993,0.6993006993006993,11.188811188811188,1.3986013986013985,9.79020979020979,6.993006993006993,6.293706293706294,0.6993006993006993,0
E00156085,122,101,43,58,0,0,16,2,14,5,4,1,0,82.78688524590164,35.24590163934426,47.540983606557376,0,0,13.114754098360656,1.639344262295082,11.475409836065573,4.098360655737705,3.278688524590164,0.819672131147541,0
E00156086,215,182,86,96,3,3,1,1,0,29,27,2,0,84.65116279069768,40,44.651162790697676,1.3953488372093024,1.3953488372093024,0.46511627906976744,0.46511627906976744,0,13.488372093023257,12.558139534883722,0.9302325581395349,0
E00156087,214,198,79,119,0,0,1,1,0,15,15,0,0,92.5233644859813,36.915887850467286,55.60747663551402,0,0,0.46728971962616817,0.46728971962616817,0,7.009345794392523,7.009345794392523,0,0
E00156088,129,115,57,58,0,0,2,0,2,12,12,0,0,89.14728682170544,44.18604651162791,44.96124031007752,0,0,1.550387596899225,0,1.550387596899225,9.30232558139535,9.30232558139535,0,0
E00156089,152,147,62,85,0,0,0,0,0,5,5,0,0,96.71052631578947,40.78947368421053,55.92105263157895,0,0,0,0,0,3.289473684210526,3.289473684210526,0,0
E00156090,120,112,74,38,1,1,2,0,2,5,3,2,0,93.33333333333333,61.66666666666667,31.666666666666664,0.8333333333333334,0.8333333333333334,1.6666666666666667,0,1.6666666666666667,4.166666666666666,2.5,1.6666666666666667,0
E00156091,128,121,71,50,0,0,0,0,0,7,6,1,0,94.53125,55.46875,39.0625,0,0,0,0,0,5.46875,4.6875,0.78125,0
E00156092,126,91,55,36,0,0,12,2,10,23,22,1,0,72.22222222222221,43.65079365079365,28.57142857142857,0,0,9.523809523809524,1.5873015873015872,7.936507936507936,18.253968253968253,17.46031746031746,0.7936507936507936,0
E00156093,117,108,69,39,0,0,5,0,5,4,4,0,0,92.3076923076923,58.97435897435898,33.33333333333333,0,0,4.273504273504273,0,4.273504273504273,3.418803418803419,3.418803418803419,0,0
E00156094,136,86,47,39,0,0,21,3,18,29,28,1,0,63.23529411764706,34.55882352941176,28.676470588235293,0,0,15.441176470588236,2.2058823529411766,13.23529411764706,21.323529411764707,20.588235294117645,0.7352941176470588,0
E00156095,137,124,61,63,0,0,1,0,1,12,10,2,0,90.51094890510949,44.52554744525548,45.98540145985402,0,0,0.7299270072992701,0,0.7299270072992701,8.75912408759124,7.2992700729927,1.4598540145985401,0
E00156096,165,159,86,73,0,0,1,0,1,5,3,2,0,96.36363636363636,52.121212121212125,44.24242424242424,0,0,0.6060606060606061,0,0.6060606060606061,3.0303030303030303,1.8181818181818181,1.2121212121212122,0
E00156097,162,127,49,78,0,0,0,0,0,35,30,5,0,78.39506172839506,30.246913580246915,48.148148148148145,0,0,0,0,0,21.604938271604937,18.51851851851852,3.0864197530864197,0
E00156098,106,53,11,42,0,0,45,4,41,8,8,0,0,50,10.377358490566039,39.62264150943396,0,0,42.45283018867924,3.7735849056603774,38.67924528301887,7.547169811320755,7.547169811320755,0,0
E00156099,167,108,25,83,0,0,39,6,33,19,16,3,1,64.67065868263472,14.97005988023952,49.700598802395206,0,0,23.353293413173652,3.592814371257485,19.760479041916167,11.377245508982035,9.580838323353294,1.7964071856287425,0.5988023952095809
E00156100,142,59,16,43,0,0,66,11,55,17,17,0,0,41.54929577464789,11.267605633802818,30.28169014084507,0,0,46.478873239436616,7.746478873239436,38.732394366197184,11.971830985915492,11.971830985915492,0,0
E00156101,121,60,16,44,0,0,46,8,38,15,15,0,0,49.586776859504134,13.223140495867769,36.36363636363637,0,0,38.01652892561984,6.6115702479338845,31.40495867768595,12.396694214876034,12.396694214876034,0,0
E00156102,108,24,6,18,0,0,73,9,64,11,9,2,0,22.22222222222222,5.555555555555555,16.666666666666664,0,0,67.5925925925926,8.333333333333332,59.25925925925925,10.185185185185185,8.333333333333332,1.8518518518518516,0
E00156103,148,82,26,56,0,0,51,10,41,15,13,2,0,55.4054054054054,17.56756756756757,37.83783783783784,0,0,34.45945945945946,6.756756756756757,27.7027027027027,10.135135135135135,8.783783783783784,1.3513513513513513,0
E00156104,108,85,32,53,0,0,19,3,16,4,4,0,0,78.70370370370371,29.629629629629626,49.074074074074076,0,0,17.59259259259259,2.7777777777777777,14.814814814814813,3.7037037037037033,3.7037037037037033,0,0
E00156106,111,84,34,50,1,1,16,2,14,10,10,0,0,75.67567567567568,30.630630630630627,45.04504504504504,0.9009009009009009,0.9009009009009009,14.414414414414415,1.8018018018018018,12.612612612612612,9.00900900900901,9.00900900900901,0,0
E00156107,123,39,11,28,33,33,45,6,39,6,6,0,0,31.70731707317073,8.94308943089431,22.76422764227642,26.82926829268293,26.82926829268293,36.58536585365854,4.878048780487805,31.70731707317073,4.878048780487805,4.878048780487805,0,0
E00156108,138,48,19,29,1,1,2,0,2,87,84,3,0,34.78260869565217,13.768115942028986,21.014492753623188,0.7246376811594203,0.7246376811594203,1.4492753623188406,0,1.4492753623188406,63.04347826086957,60.86956521739131,2.1739130434782608,0
E00156110,113,77,41,36,0,0,2,0,2,34,29,5,0,68.14159292035397,36.283185840707965,31.858407079646017,0,0,1.7699115044247788,0,1.7699115044247788,30.08849557522124,25.663716814159294,4.424778761061947,0
E00156111,122,107,48,59,0,0,0,0,0,15,14,1,0,87.70491803278688,39.34426229508197,48.36065573770492,0,0,0,0,0,12.295081967213115,11.475409836065573,0.819672131147541,0
E00156112,152,128,69,59,0,0,0,0,0,24,22,2,0,84.21052631578947,45.39473684210527,38.81578947368421,0,0,0,0,0,15.789473684210526,14.473684210526317,1.3157894736842104,0
E00156113,206,87,52,35,1,1,74,4,70,44,44,0,0,42.23300970873786,25.24271844660194,16.990291262135923,0.48543689320388345,0.48543689320388345,35.92233009708738,1.9417475728155338,33.980582524271846,21.35922330097087,21.35922330097087,0,0
E00156114,159,85,60,25,0,0,15,0,15,59,56,3,0,53.459119496855344,37.735849056603776,15.723270440251572,0,0,9.433962264150944,0,9.433962264150944,37.10691823899371,35.22012578616352,1.8867924528301887,0
E00156115,64,51,20,31,1,1,0,0,0,12,12,0,0,79.6875,31.25,48.4375,1.5625,1.5625,0,0,0,18.75,18.75,0,0
E00156116,164,72,30,42,0,0,5,0,5,87,85,2,0,43.90243902439025,18.29268292682927,25.609756097560975,0,0,3.048780487804878,0,3.048780487804878,53.04878048780488,51.829268292682926,1.2195121951219512,0
E00156118,110,92,31,61,7,7,1,0,1,10,9,1,0,83.63636363636363,28.18181818181818,55.45454545454545,6.363636363636363,6.363636363636363,0.9090909090909091,0,0.9090909090909091,9.090909090909092,8.181818181818182,0.9090909090909091,0
E00156119,141,75,27,48,0,0,0,0,0,66,62,4,0,53.191489361702125,19.148936170212767,34.04255319148936,0,0,0,0,0,46.808510638297875,43.97163120567376,2.8368794326241136,0
E00156120,131,83,32,51,0,0,1,0,1,47,43,4,0,63.358778625954194,24.427480916030532,38.93129770992366,0,0,0.7633587786259541,0,0.7633587786259541,35.87786259541985,32.82442748091603,3.0534351145038165,0
E00156121,134,75,21,54,1,1,3,0,3,55,54,1,0,55.970149253731336,15.671641791044777,40.298507462686565,0.7462686567164178,0.7462686567164178,2.2388059701492535,0,2.2388059701492535,41.04477611940299,40.298507462686565,0.7462686567164178,0
E00156123,104,96,34,62,0,0,1,0,1,7,7,0,0,92.3076923076923,32.69230769230769,59.61538461538461,0,0,0.9615384615384616,0,0.9615384615384616,6.730769230769231,6.730769230769231,0,0
E00156124,143,90,24,66,4,4,28,4,24,21,20,1,0,62.93706293706294,16.783216783216783,46.15384615384615,2.797202797202797,2.797202797202797,19.58041958041958,2.797202797202797,16.783216783216783,14.685314685314685,13.986013986013987,0.6993006993006993,0
E00156126,130,106,41,65,1,1,12,3,9,11,8,3,0,81.53846153846153,31.538461538461537,50,0.7692307692307693,0.7692307692307693,9.230769230769232,2.307692307692308,6.923076923076923,8.461538461538462,6.153846153846154,2.307692307692308,0
E00156127,119,92,46,46,0,0,8,0,8,19,15,4,0,77.31092436974791,38.655462184873954,38.655462184873954,0,0,6.722689075630252,0,6.722689075630252,15.966386554621847,12.605042016806722,3.361344537815126,0
E00156128,155,78,30,48,0,0,53,4,49,24,24,0,0,50.32258064516129,19.35483870967742,30.967741935483872,0,0,34.193548387096776,2.5806451612903225,31.61290322580645,15.483870967741936,15.483870967741936,0,0
E00156129,106,88,46,42,0,0,0,0,0,18,17,1,0,83.01886792452831,43.39622641509434,39.62264150943396,0,0,0,0,0,16.9811320754717,16.037735849056602,0.9433962264150944,0
E00156130,127,103,28,75,4,4,2,0,2,18,16,2,0,81.10236220472441,22.04724409448819,59.055118110236215,3.149606299212598,3.149606299212598,1.574803149606299,0,1.574803149606299,14.173228346456693,12.598425196850393,1.574803149606299,0
E00156131,115,89,53,36,0,0,2,0,2,24,23,1,0,77.39130434782608,46.08695652173913,31.30434782608696,0,0,1.7391304347826086,0,1.7391304347826086,20.869565217391305,20,0.8695652173913043,0
E00156132,129,86,28,58,1,1,4,1,3,38,37,1,0,66.66666666666666,21.705426356589147,44.96124031007752,0.7751937984496124,0.7751937984496124,3.10077519379845,0.7751937984496124,2.3255813953488373,29.457364341085274,28.68217054263566,0.7751937984496124,0
E00156133,112,52,20,32,0,0,3,0,3,56,53,3,1,46.42857142857143,17.857142857142858,28.57142857142857,0,0,2.6785714285714284,0,2.6785714285714284,50,47.32142857142857,2.6785714285714284,0.8928571428571428
E00156134,121,29,11,18,1,1,56,23,33,35,34,1,0,23.96694214876033,9.090909090909092,14.87603305785124,0.8264462809917356,0.8264462809917356,46.28099173553719,19.00826446280992,27.27272727272727,28.92561983471074,28.09917355371901,0.8264462809917356,0
E00156135,164,91,40,51,23,23,11,4,7,39,36,3,0,55.487804878048784,24.390243902439025,31.097560975609756,14.02439024390244,14.02439024390244,6.707317073170732,2.4390243902439024,4.2682926829268295,23.78048780487805,21.951219512195124,1.8292682926829267,0
E00156136,129,116,49,67,0,0,0,0,0,13,13,0,0,89.92248062015504,37.98449612403101,51.93798449612403,0,0,0,0,0,10.077519379844961,10.077519379844961,0,0
E00156137,133,9,1,8,4,4,115,13,102,5,5,0,0,6.7669172932330826,0.7518796992481203,6.015037593984962,3.007518796992481,3.007518796992481,86.46616541353383,9.774436090225564,76.69172932330827,3.7593984962406015,3.7593984962406015,0,0
E00156138,131,126,86,40,0,0,0,0,0,5,5,0,0,96.18320610687023,65.64885496183206,30.53435114503817,0,0,0,0,0,3.816793893129771,3.816793893129771,0,0
E00156139,121,115,66,49,0,0,0,0,0,6,6,0,0,95.0413223140496,54.54545454545454,40.49586776859504,0,0,0,0,0,4.958677685950414,4.958677685950414,0,0
E00156140,183,108,59,49,0,0,1,0,1,74,68,6,0,59.01639344262295,32.240437158469945,26.775956284153008,0,0,0.546448087431694,0,0.546448087431694,40.43715846994536,37.15846994535519,3.278688524590164,0
E00156141,191,132,96,36,3,3,4,0,4,52,45,7,0,69.10994764397905,50.26178010471204,18.848167539267017,1.5706806282722512,1.5706806282722512,2.094240837696335,0,2.094240837696335,27.225130890052355,23.56020942408377,3.664921465968586,0
E00156142,138,122,83,39,0,0,3,1,2,13,12,1,0,88.40579710144928,60.14492753623188,28.26086956521739,0,0,2.1739130434782608,0.7246376811594203,1.4492753623188406,9.420289855072465,8.695652173913043,0.7246376811594203,0
E00156143,158,55,21,34,3,3,45,12,33,55,52,3,0,34.810126582278485,13.291139240506327,21.518987341772153,1.89873417721519,1.89873417721519,28.48101265822785,7.59493670886076,20.88607594936709,34.810126582278485,32.91139240506329,1.89873417721519,0
E00156144,135,111,53,58,0,0,3,0,3,21,19,2,0,82.22222222222221,39.25925925925926,42.96296296296296,0,0,2.2222222222222223,0,2.2222222222222223,15.555555555555555,14.074074074074074,1.4814814814814816,0
E00156145,136,21,11,10,3,3,101,22,79,10,10,0,1,15.441176470588236,8.088235294117647,7.352941176470589,2.2058823529411766,2.2058823529411766,74.26470588235294,16.176470588235293,58.08823529411765,7.352941176470589,7.352941176470589,0,0.7352941176470588
E00156146,124,56,29,27,0,0,34,11,23,34,33,1,0,45.16129032258064,23.387096774193548,21.774193548387096,0,0,27.419354838709676,8.870967741935484,18.548387096774192,27.419354838709676,26.61290322580645,0.8064516129032258,0
E00156148,185,40,14,26,0,0,50,14,36,95,91,4,0,21.62162162162162,7.567567567567568,14.054054054054054,0,0,27.027027027027028,7.567567567567568,19.45945945945946,51.35135135135135,49.18918918918919,2.1621621621621623,0
E00156149,121,75,28,47,0,0,32,12,20,14,12,2,0,61.98347107438017,23.140495867768596,38.84297520661157,0,0,26.446280991735538,9.917355371900827,16.528925619834713,11.570247933884298,9.917355371900827,1.6528925619834711,0
E00156150,133,117,34,83,1,1,1,0,1,14,13,1,0,87.96992481203007,25.563909774436087,62.40601503759399,0.7518796992481203,0.7518796992481203,0.7518796992481203,0,0.7518796992481203,10.526315789473683,9.774436090225564,0.7518796992481203,0
E00156151,104,84,54,30,1,1,14,2,12,5,5,0,0,80.76923076923077,51.92307692307693,28.846153846153843,0.9615384615384616,0.9615384615384616,13.461538461538462,1.9230769230769231,11.538461538461538,4.807692307692308,4.807692307692308,0,0
E00156152,179,98,51,47,1,1,29,4,25,51,47,4,0,54.7486033519553,28.49162011173184,26.256983240223462,0.5586592178770949,0.5586592178770949,16.201117318435752,2.2346368715083798,13.966480446927374,28.49162011173184,26.256983240223462,2.2346368715083798,0
E00156153,116,100,55,45,0,0,3,1,2,13,12,1,0,86.20689655172413,47.41379310344828,38.793103448275865,0,0,2.586206896551724,0.8620689655172413,1.7241379310344827,11.206896551724139,10.344827586206897,0.8620689655172413,0
E00156154,130,85,63,22,7,7,15,0,15,23,19,4,0,65.38461538461539,48.46153846153846,16.923076923076923,5.384615384615385,5.384615384615385,11.538461538461538,0,11.538461538461538,17.692307692307693,14.615384615384617,3.076923076923077,0
E00156155,171,97,46,51,7,7,54,5,49,13,13,0,0,56.72514619883041,26.900584795321635,29.82456140350877,4.093567251461988,4.093567251461988,31.57894736842105,2.923976608187134,28.654970760233915,7.602339181286549,7.602339181286549,0,0
E00156156,129,73,24,49,5,5,35,5,30,16,14,2,0,56.58914728682171,18.6046511627907,37.98449612403101,3.875968992248062,3.875968992248062,27.131782945736433,3.875968992248062,23.25581395348837,12.4031007751938,10.852713178294573,1.550387596899225,0
E00156157,125,9,3,6,1,1,105,15,90,10,10,0,0,7.199999999999999,2.4,4.8,0.8,0.8,84,12,72,8,8,0,0
E00156158,141,131,68,63,0,0,1,0,1,9,5,4,0,92.90780141843972,48.226950354609926,44.680851063829785,0,0,0.7092198581560284,0,0.7092198581560284,6.382978723404255,3.546099290780142,2.8368794326241136,0
E00156159,127,109,48,61,0,0,1,0,1,17,14,3,0,85.8267716535433,37.79527559055118,48.031496062992126,0,0,0.7874015748031495,0,0.7874015748031495,13.385826771653544,11.023622047244094,2.3622047244094486,0
E00156160,122,97,79,18,1,1,2,1,1,22,16,6,0,79.50819672131148,64.75409836065575,14.754098360655737,0.819672131147541,0.819672131147541,1.639344262295082,0.819672131147541,0.819672131147541,18.0327868852459,13.114754098360656,4.918032786885246,0
E00156161,119,78,38,40,0,0,21,0,21,20,20,0,0,65.54621848739495,31.932773109243694,33.61344537815126,0,0,17.647058823529413,0,17.647058823529413,16.80672268907563,16.80672268907563,0,0
E00156162,235,93,55,38,0,0,0,0,0,142,132,10,0,39.57446808510638,23.404255319148938,16.170212765957448,0,0,0,0,0,60.42553191489362,56.17021276595745,4.25531914893617,0
E00156163,104,92,48,44,0,0,1,0,1,11,7,4,0,88.46153846153845,46.15384615384615,42.30769230769231,0,0,0.9615384615384616,0,0.9615384615384616,10.576923076923077,6.730769230769231,3.8461538461538463,0
E00156164,123,113,69,44,0,0,1,0,1,9,7,2,0,91.869918699187,56.09756097560976,35.77235772357724,0,0,0.8130081300813009,0,0.8130081300813009,7.317073170731707,5.691056910569105,1.6260162601626018,0
E00156165,156,129,78,51,0,0,6,0,6,21,17,4,0,82.6923076923077,50,32.69230769230769,0,0,3.8461538461538463,0,3.8461538461538463,13.461538461538462,10.897435897435898,2.564102564102564,0
E00156166,130,96,29,67,0,0,0,0,0,34,28,6,0,73.84615384615385,22.30769230769231,51.53846153846153,0,0,0,0,0,26.153846153846157,21.53846153846154,4.615384615384616,0
E00156167,135,112,50,62,0,0,1,0,1,22,17,5,0,82.96296296296296,37.03703703703704,45.925925925925924,0,0,0.7407407407407408,0,0.7407407407407408,16.296296296296298,12.592592592592592,3.7037037037037033,0
E00156168,133,108,56,52,3,3,5,0,5,17,16,1,0,81.203007518797,42.10526315789473,39.097744360902254,2.2556390977443606,2.2556390977443606,3.7593984962406015,0,3.7593984962406015,12.781954887218044,12.030075187969924,0.7518796992481203,0
E00156169,141,74,45,29,0,0,3,1,2,64,60,4,0,52.4822695035461,31.914893617021278,20.56737588652482,0,0,2.127659574468085,0.7092198581560284,1.4184397163120568,45.39007092198582,42.5531914893617,2.8368794326241136,0
E00156170,113,78,35,43,0,0,18,1,17,17,15,2,0,69.02654867256636,30.973451327433626,38.05309734513274,0,0,15.929203539823009,0.8849557522123894,15.04424778761062,15.04424778761062,13.274336283185843,1.7699115044247788,0
E00156171,134,113,40,73,2,2,1,0,1,18,16,2,0,84.32835820895522,29.850746268656714,54.47761194029851,1.4925373134328357,1.4925373134328357,0.7462686567164178,0,0.7462686567164178,13.432835820895523,11.940298507462686,1.4925373134328357,0
E00156172,111,77,33,44,0,0,9,3,6,25,22,3,0,69.36936936936937,29.72972972972973,39.63963963963964,0,0,8.108108108108109,2.7027027027027026,5.405405405405405,22.52252252252252,19.81981981981982,2.7027027027027026,0
E00156173,120,92,51,41,0,0,14,4,10,14,11,3,0,76.66666666666667,42.5,34.166666666666664,0,0,11.666666666666666,3.3333333333333335,8.333333333333332,11.666666666666666,9.166666666666666,2.5,0
E00156174,142,76,37,39,1,1,1,0,1,64,58,6,0,53.52112676056338,26.056338028169012,27.464788732394368,0.7042253521126761,0.7042253521126761,0.7042253521126761,0,0.7042253521126761,45.07042253521127,40.845070422535215,4.225352112676056,0
E00156175,154,99,31,68,2,2,11,0,11,42,38,4,0,64.28571428571429,20.12987012987013,44.15584415584416,1.2987012987012987,1.2987012987012987,7.142857142857142,0,7.142857142857142,27.27272727272727,24.675324675324674,2.5974025974025974,0
E00156176,127,77,29,48,0,0,18,2,16,32,32,0,0,60.629921259842526,22.83464566929134,37.79527559055118,0,0,14.173228346456693,1.574803149606299,12.598425196850393,25.196850393700785,25.196850393700785,0,0
E00156177,124,107,37,70,0,0,2,0,2,15,13,2,0,86.29032258064517,29.838709677419356,56.451612903225815,0,0,1.6129032258064515,0,1.6129032258064515,12.096774193548388,10.483870967741936,1.6129032258064515,0
E00156178,104,49,24,25,0,0,4,1,3,51,49,2,0,47.11538461538461,23.076923076923077,24.03846153846154,0,0,3.8461538461538463,0.9615384615384616,2.8846153846153846,49.03846153846153,47.11538461538461,1.9230769230769231,0
E00156179,138,8,4,4,12,12,116,5,111,2,2,0,0,5.797101449275362,2.898550724637681,2.898550724637681,8.695652173913043,8.695652173913043,84.05797101449275,3.6231884057971016,80.43478260869566,1.4492753623188406,1.4492753623188406,0,0
E00156180,147,80,46,34,2,2,33,3,30,32,28,4,0,54.421768707483,31.292517006802722,23.12925170068027,1.3605442176870748,1.3605442176870748,22.448979591836736,2.0408163265306123,20.408163265306122,21.768707482993197,19.047619047619047,2.7210884353741496,0
E00156181,180,115,52,63,2,2,15,0,15,48,45,3,0,63.888888888888886,28.888888888888886,35,1.1111111111111112,1.1111111111111112,8.333333333333332,0,8.333333333333332,26.666666666666668,25,1.6666666666666667,0
E00156182,152,98,44,54,0,0,15,1,14,39,37,2,0,64.47368421052632,28.947368421052634,35.526315789473685,0,0,9.868421052631579,0.6578947368421052,9.210526315789473,25.657894736842106,24.342105263157894,1.3157894736842104,0
E00156184,54,51,32,19,0,0,0,0,0,3,1,2,0,94.44444444444444,59.25925925925925,35.18518518518518,0,0,0,0,0,5.555555555555555,1.8518518518518516,3.7037037037037033,0
E00156185,138,132,81,51,0,0,0,0,0,6,5,1,0,95.65217391304348,58.69565217391305,36.95652173913043,0,0,0,0,0,4.3478260869565215,3.6231884057971016,0.7246376811594203,0
E00156186,123,84,45,39,0,0,2,1,1,37,36,1,0,68.29268292682927,36.58536585365854,31.70731707317073,0,0,1.6260162601626018,0.8130081300813009,0.8130081300813009,30.081300813008134,29.268292682926827,0.8130081300813009,0
E00156187,154,116,84,32,0,0,4,0,4,34,31,3,0,75.32467532467533,54.54545454545454,20.77922077922078,0,0,2.5974025974025974,0,2.5974025974025974,22.07792207792208,20.12987012987013,1.948051948051948,0
E00156188,145,131,77,54,1,1,1,0,1,12,12,0,0,90.3448275862069,53.103448275862064,37.24137931034483,0.6896551724137931,0.6896551724137931,0.6896551724137931,0,0.6896551724137931,8.275862068965518,8.275862068965518,0,0
E00156189,127,100,52,48,0,0,3,2,1,24,22,2,0,78.74015748031496,40.94488188976378,37.79527559055118,0,0,2.3622047244094486,1.574803149606299,0.7874015748031495,18.89763779527559,17.322834645669293,1.574803149606299,0
E00156190,146,144,67,77,1,1,1,0,1,0,0,0,0,98.63013698630137,45.89041095890411,52.73972602739726,0.684931506849315,0.684931506849315,0.684931506849315,0,0.684931506849315,0,0,0,0
E00156191,137,119,77,42,0,0,1,1,0,17,16,1,0,86.86131386861314,56.20437956204379,30.656934306569344,0,0,0.7299270072992701,0.7299270072992701,0,12.408759124087592,11.678832116788321,0.7299270072992701,0
E00156192,144,61,26,35,0,0,4,0,4,79,74,5,0,42.36111111111111,18.055555555555554,24.305555555555554,0,0,2.7777777777777777,0,2.7777777777777777,54.861111111111114,51.388888888888886,3.4722222222222223,0
E00156193,152,113,64,49,1,1,4,0,4,34,30,4,0,74.3421052631579,42.10526315789473,32.23684210526316,0.6578947368421052,0.6578947368421052,2.631578947368421,0,2.631578947368421,22.36842105263158,19.736842105263158,2.631578947368421,0
E00156194,153,83,22,61,1,1,6,0,6,63,60,3,0,54.248366013071895,14.37908496732026,39.869281045751634,0.6535947712418301,0.6535947712418301,3.9215686274509802,0,3.9215686274509802,41.17647058823529,39.21568627450981,1.9607843137254901,0
E00156195,151,76,49,27,0,0,3,0,3,72,70,2,0,50.331125827814574,32.450331125827816,17.880794701986755,0,0,1.9867549668874174,0,1.9867549668874174,47.682119205298015,46.35761589403973,1.3245033112582782,0
E00156196,180,149,74,75,0,0,0,0,0,31,29,2,0,82.77777777777777,41.11111111111111,41.66666666666667,0,0,0,0,0,17.22222222222222,16.11111111111111,1.1111111111111112,0
E00156197,196,121,40,81,3,3,5,0,5,67,65,2,0,61.73469387755102,20.408163265306122,41.3265306122449,1.530612244897959,1.530612244897959,2.5510204081632653,0,2.5510204081632653,34.183673469387756,33.16326530612245,1.0204081632653061,0
E00156198,126,106,46,60,0,0,1,0,1,19,17,2,0,84.12698412698413,36.507936507936506,47.61904761904761,0,0,0.7936507936507936,0,0.7936507936507936,15.079365079365079,13.492063492063492,1.5873015873015872,0
E00156199,136,91,30,61,3,3,12,0,12,30,27,3,0,66.91176470588235,22.058823529411764,44.85294117647059,2.2058823529411766,2.2058823529411766,8.823529411764707,0,8.823529411764707,22.058823529411764,19.852941176470587,2.2058823529411766,0
E00156201,157,145,74,71,0,0,2,1,1,10,7,3,0,92.35668789808918,47.13375796178344,45.22292993630573,0,0,1.2738853503184715,0.6369426751592357,0.6369426751592357,6.369426751592357,4.45859872611465,1.910828025477707,0
E00156202,138,119,72,47,1,1,7,1,6,11,8,3,0,86.23188405797102,52.17391304347826,34.05797101449276,0.7246376811594203,0.7246376811594203,5.072463768115942,0.7246376811594203,4.3478260869565215,7.971014492753622,5.797101449275362,2.1739130434782608,0
E00156203,115,107,80,27,1,1,1,0,1,6,4,2,0,93.04347826086956,69.56521739130434,23.47826086956522,0.8695652173913043,0.8695652173913043,0.8695652173913043,0,0.8695652173913043,5.217391304347826,3.4782608695652173,1.7391304347826086,0
E00156204,155,115,57,58,3,3,24,6,18,13,9,4,0,74.19354838709677,36.774193548387096,37.41935483870968,1.935483870967742,1.935483870967742,15.483870967741936,3.870967741935484,11.612903225806452,8.38709677419355,5.806451612903226,2.5806451612903225,0
E00156205,160,123,69,54,0,0,0,0,0,37,28,9,0,76.875,43.125,33.75,0,0,0,0,0,23.125,17.5,5.625,0
E00156206,121,105,61,44,0,0,3,1,2,13,10,3,0,86.77685950413223,50.413223140495866,36.36363636363637,0,0,2.479338842975207,0.8264462809917356,1.6528925619834711,10.743801652892563,8.264462809917356,2.479338842975207,0
E00156207,167,124,36,88,1,1,3,0,3,39,34,5,0,74.25149700598801,21.55688622754491,52.69461077844312,0.5988023952095809,0.5988023952095809,1.7964071856287425,0,1.7964071856287425,23.353293413173652,20.359281437125748,2.9940119760479043,0
E00156208,160,142,74,68,0,0,6,1,5,12,9,3,0,88.75,46.25,42.5,0,0,3.75,0.625,3.125,7.5,5.625,1.875,0
E00156209,152,50,24,26,3,3,89,9,80,10,7,3,0,32.89473684210527,15.789473684210526,17.105263157894736,1.9736842105263157,1.9736842105263157,58.55263157894737,5.921052631578947,52.63157894736842,6.578947368421052,4.605263157894736,1.9736842105263157,0
E00156210,101,38,14,24,0,0,53,7,46,10,7,3,0,37.62376237623762,13.861386138613863,23.762376237623762,0,0,52.475247524752476,6.9306930693069315,45.54455445544555,9.900990099009901,6.9306930693069315,2.9702970297029703,0
E00156211,108,34,14,20,1,1,65,14,51,8,7,1,0,31.48148148148148,12.962962962962962,18.51851851851852,0.9259259259259258,0.9259259259259258,60.18518518518518,12.962962962962962,47.22222222222222,7.4074074074074066,6.481481481481481,0.9259259259259258,0
E00156212,155,135,60,75,0,0,5,1,4,15,11,4,0,87.09677419354838,38.70967741935484,48.38709677419355,0,0,3.225806451612903,0.6451612903225806,2.5806451612903225,9.67741935483871,7.096774193548387,2.5806451612903225,0
E00156213,131,111,50,61,0,0,10,4,6,10,9,1,0,84.7328244274809,38.16793893129771,46.56488549618321,0,0,7.633587786259542,3.0534351145038165,4.580152671755725,7.633587786259542,6.870229007633588,0.7633587786259541,0
E00156214,97,80,36,44,0,0,8,3,5,9,9,0,0,82.4742268041237,37.11340206185567,45.36082474226804,0,0,8.24742268041237,3.0927835051546393,5.154639175257731,9.278350515463918,9.278350515463918,0,0
E00156215,128,117,79,38,0,0,2,0,2,9,6,3,0,91.40625,61.71875,29.6875,0,0,1.5625,0,1.5625,7.03125,4.6875,2.34375,0
E00156216,140,69,28,41,0,0,26,5,21,45,42,3,0,49.28571428571429,20,29.28571428571429,0,0,18.571428571428573,3.571428571428571,15,32.142857142857146,30,2.142857142857143,0
E00156217,124,80,29,51,0,0,32,5,27,12,9,3,0,64.51612903225806,23.387096774193548,41.12903225806452,0,0,25.806451612903224,4.032258064516129,21.774193548387096,9.67741935483871,7.258064516129033,2.4193548387096775,0
E00156218,147,88,52,36,0,0,42,7,35,17,16,1,0,59.863945578231295,35.374149659863946,24.489795918367346,0,0,28.57142857142857,4.761904761904762,23.809523809523807,11.564625850340136,10.884353741496598,0.6802721088435374,0
E00156219,96,49,15,34,0,0,41,3,38,6,5,1,0,51.041666666666664,15.625,35.41666666666667,0,0,42.70833333333333,3.125,39.58333333333333,6.25,5.208333333333334,1.0416666666666665,0
E00156220,106,87,50,37,1,1,2,0,2,16,14,2,0,82.0754716981132,47.16981132075472,34.90566037735849,0.9433962264150944,0.9433962264150944,1.8867924528301887,0,1.8867924528301887,15.09433962264151,13.20754716981132,1.8867924528301887,0
E00156221,124,50,19,31,8,8,60,9,51,6,6,0,0,40.32258064516129,15.32258064516129,25,6.451612903225806,6.451612903225806,48.38709677419355,7.258064516129033,41.12903225806452,4.838709677419355,4.838709677419355,0,0
E00156222,110,55,19,36,0,0,46,12,34,9,8,1,0,50,17.272727272727273,32.72727272727273,0,0,41.81818181818181,10.909090909090908,30.909090909090907,8.181818181818182,7.2727272727272725,0.9090909090909091,0
E00156223,117,105,44,61,0,0,0,0,0,12,11,1,0,89.74358974358975,37.60683760683761,52.13675213675214,0,0,0,0,0,10.256410256410255,9.401709401709402,0.8547008547008548,0
E00156224,54,46,28,18,1,1,0,0,0,7,7,0,0,85.18518518518519,51.85185185185185,33.33333333333333,1.8518518518518516,1.8518518518518516,0,0,0,12.962962962962962,12.962962962962962,0,0
E00156225,106,81,42,39,1,1,17,5,12,7,6,1,0,76.41509433962264,39.62264150943396,36.79245283018868,0.9433962264150944,0.9433962264150944,16.037735849056602,4.716981132075472,11.320754716981133,6.60377358490566,5.660377358490567,0.9433962264150944,0
E00156226,103,47,23,24,1,1,47,14,33,8,7,1,0,45.63106796116505,22.330097087378643,23.300970873786408,0.9708737864077669,0.9708737864077669,45.63106796116505,13.592233009708737,32.038834951456316,7.766990291262135,6.796116504854369,0.9708737864077669,0
E00156227,112,112,46,66,0,0,0,0,0,0,0,0,0,100,41.07142857142857,58.92857142857143,0,0,0,0,0,0,0,0,0
E00156228,119,75,35,40,0,0,40,13,27,4,4,0,0,63.02521008403361,29.411764705882355,33.61344537815126,0,0,33.61344537815126,10.92436974789916,22.689075630252102,3.361344537815126,3.361344537815126,0,0
E00156229,109,50,17,33,0,0,53,11,42,6,4,2,0,45.87155963302752,15.59633027522936,30.275229357798167,0,0,48.62385321100918,10.091743119266056,38.53211009174312,5.5045871559633035,3.669724770642202,1.834862385321101,0
E00156230,129,39,15,24,0,0,77,17,60,13,9,4,0,30.23255813953488,11.627906976744185,18.6046511627907,0,0,59.68992248062015,13.178294573643413,46.51162790697674,10.077519379844961,6.976744186046512,3.10077519379845,0
E00156231,129,119,59,60,1,1,0,0,0,9,7,2,0,92.24806201550388,45.73643410852713,46.51162790697674,0.7751937984496124,0.7751937984496124,0,0,0,6.976744186046512,5.426356589147287,1.550387596899225,0
E00156232,136,121,69,52,0,0,6,2,4,9,5,4,0,88.97058823529412,50.73529411764706,38.23529411764706,0,0,4.411764705882353,1.4705882352941175,2.941176470588235,6.61764705882353,3.6764705882352944,2.941176470588235,0
E00156233,125,111,71,40,0,0,1,0,1,13,12,1,0,88.8,56.8,32,0,0,0.8,0,0.8,10.4,9.6,0.8,0
E00156234,119,116,54,62,0,0,0,0,0,3,3,0,0,97.47899159663865,45.378151260504204,52.10084033613446,0,0,0,0,0,2.5210084033613445,2.5210084033613445,0,0
E00156235,110,97,55,42,0,0,2,2,0,11,9,2,0,88.18181818181819,50,38.18181818181819,0,0,1.8181818181818181,1.8181818181818181,0,10,8.181818181818182,1.8181818181818181,0
E00156236,115,105,53,52,0,0,2,1,1,8,6,2,0,91.30434782608695,46.08695652173913,45.21739130434783,0,0,1.7391304347826086,0.8695652173913043,0.8695652173913043,6.956521739130435,5.217391304347826,1.7391304347826086,0
E00156237,132,122,84,38,1,1,1,1,0,8,8,0,0,92.42424242424242,63.63636363636363,28.78787878787879,0.7575757575757576,0.7575757575757576,0.7575757575757576,0.7575757575757576,0,6.0606060606060606,6.0606060606060606,0,0
E00156238,129,114,98,16,0,0,3,0,3,12,10,2,0,88.37209302325581,75.96899224806202,12.4031007751938,0,0,2.3255813953488373,0,2.3255813953488373,9.30232558139535,7.751937984496124,1.550387596899225,0
E00156239,130,114,76,38,1,1,1,0,1,14,12,2,0,87.6923076923077,58.46153846153847,29.230769230769234,0.7692307692307693,0.7692307692307693,0.7692307692307693,0,0.7692307692307693,10.76923076923077,9.230769230769232,1.5384615384615385,0
E00156240,102,78,48,30,0,0,1,0,1,23,19,4,0,76.47058823529412,47.05882352941176,29.411764705882355,0,0,0.9803921568627451,0,0.9803921568627451,22.54901960784314,18.627450980392158,3.9215686274509802,0
E00156241,122,102,50,52,0,0,7,1,6,13,9,4,0,83.60655737704919,40.98360655737705,42.62295081967213,0,0,5.737704918032787,0.819672131147541,4.918032786885246,10.655737704918032,7.377049180327869,3.278688524590164,0
E00156242,91,75,34,41,0,0,0,0,0,16,16,0,0,82.41758241758241,37.362637362637365,45.05494505494506,0,0,0,0,0,17.582417582417584,17.582417582417584,0,0
E00156243,126,86,43,43,0,0,1,0,1,39,35,4,0,68.25396825396825,34.12698412698413,34.12698412698413,0,0,0.7936507936507936,0,0.7936507936507936,30.952380952380953,27.77777777777778,3.1746031746031744,0
E00156244,149,104,48,56,1,1,23,2,21,21,18,3,0,69.79865771812081,32.21476510067114,37.58389261744966,0.6711409395973155,0.6711409395973155,15.436241610738255,1.342281879194631,14.093959731543624,14.093959731543624,12.080536912751679,2.013422818791946,0
E00156245,106,79,46,33,0,0,13,3,10,14,12,2,0,74.52830188679245,43.39622641509434,31.132075471698112,0,0,12.264150943396226,2.8301886792452833,9.433962264150944,13.20754716981132,11.320754716981133,1.8867924528301887,0
E00156246,120,100,63,37,3,3,7,2,5,10,8,2,0,83.33333333333334,52.5,30.833333333333336,2.5,2.5,5.833333333333333,1.6666666666666667,4.166666666666666,8.333333333333332,6.666666666666667,1.6666666666666667,0
E00156247,156,148,85,63,0,0,2,1,1,6,6,0,0,94.87179487179486,54.48717948717948,40.38461538461539,0,0,1.282051282051282,0.641025641025641,0.641025641025641,3.8461538461538463,3.8461538461538463,0,0
E00156248,103,65,21,44,0,0,25,4,21,13,11,2,0,63.10679611650486,20.388349514563107,42.71844660194174,0,0,24.271844660194176,3.8834951456310676,20.388349514563107,12.62135922330097,10.679611650485436,1.9417475728155338,0
E00156249,112,109,47,62,0,0,2,0,2,1,1,0,0,97.32142857142857,41.964285714285715,55.35714285714286,0,0,1.7857142857142856,0,1.7857142857142856,0.8928571428571428,0.8928571428571428,0,0
E00156250,110,107,64,43,0,0,1,0,1,2,2,0,0,97.27272727272728,58.18181818181818,39.09090909090909,0,0,0.9090909090909091,0,0.9090909090909091,1.8181818181818181,1.8181818181818181,0,0
E00156251,124,116,69,47,0,0,2,0,2,6,6,0,0,93.54838709677419,55.64516129032258,37.903225806451616,0,0,1.6129032258064515,0,1.6129032258064515,4.838709677419355,4.838709677419355,0,0
E00156252,120,111,65,46,0,0,2,0,2,7,3,4,0,92.5,54.166666666666664,38.333333333333336,0,0,1.6666666666666667,0,1.6666666666666667,5.833333333333333,2.5,3.3333333333333335,0
E00156253,131,114,56,58,0,0,3,0,3,14,14,0,0,87.02290076335878,42.74809160305343,44.274809160305345,0,0,2.2900763358778624,0,2.2900763358778624,10.687022900763358,10.687022900763358,0,0
E00156254,112,106,65,41,0,0,0,0,0,6,6,0,0,94.64285714285714,58.03571428571429,36.607142857142854,0,0,0,0,0,5.357142857142857,5.357142857142857,0,0
E00156255,117,109,76,33,0,0,0,0,0,8,7,1,0,93.16239316239316,64.95726495726495,28.205128205128204,0,0,0,0,0,6.837606837606838,5.982905982905983,0.8547008547008548,0
E00156256,134,106,66,40,0,0,1,0,1,27,23,4,0,79.1044776119403,49.25373134328358,29.850746268656714,0,0,0.7462686567164178,0,0.7462686567164178,20.149253731343283,17.16417910447761,2.9850746268656714,0
E00156257,128,106,60,46,0,0,1,0,1,21,20,1,0,82.8125,46.875,35.9375,0,0,0.78125,0,0.78125,16.40625,15.625,0.78125,0
E00156258,136,50,21,29,1,1,73,10,63,9,7,2,3,36.76470588235294,15.441176470588236,21.323529411764707,0.7352941176470588,0.7352941176470588,53.67647058823529,7.352941176470589,46.32352941176471,6.61764705882353,5.147058823529411,1.4705882352941175,2.2058823529411766
E00156259,108,83,41,42,1,1,2,0,2,22,18,4,0,76.85185185185185,37.96296296296296,38.88888888888889,0.9259259259259258,0.9259259259259258,1.8518518518518516,0,1.8518518518518516,20.37037037037037,16.666666666666664,3.7037037037037033,0
E00156260,138,133,77,56,0,0,1,0,1,4,4,0,0,96.37681159420289,55.79710144927537,40.57971014492754,0,0,0.7246376811594203,0,0.7246376811594203,2.898550724637681,2.898550724637681,0,0
E00156261,138,98,43,55,3,3,24,5,19,13,11,2,0,71.01449275362319,31.15942028985507,39.85507246376812,2.1739130434782608,2.1739130434782608,17.391304347826086,3.6231884057971016,13.768115942028986,9.420289855072465,7.971014492753622,1.4492753623188406,0
E00156262,120,79,40,39,0,0,32,4,28,9,9,0,0,65.83333333333333,33.33333333333333,32.5,0,0,26.666666666666668,3.3333333333333335,23.333333333333332,7.5,7.5,0,0
E00156263,126,119,83,36,0,0,1,0,1,6,4,2,0,94.44444444444444,65.87301587301587,28.57142857142857,0,0,0.7936507936507936,0,0.7936507936507936,4.761904761904762,3.1746031746031744,1.5873015873015872,0
E00156264,126,116,64,52,0,0,3,1,2,7,7,0,0,92.06349206349206,50.79365079365079,41.269841269841265,0,0,2.380952380952381,0.7936507936507936,1.5873015873015872,5.555555555555555,5.555555555555555,0,0
E00156265,128,123,63,60,0,0,2,0,2,3,1,2,0,96.09375,49.21875,46.875,0,0,1.5625,0,1.5625,2.34375,0.78125,1.5625,0
E00156266,149,135,62,73,0,0,5,1,4,9,9,0,0,90.60402684563759,41.61073825503356,48.99328859060403,0,0,3.3557046979865772,0.6711409395973155,2.684563758389262,6.0402684563758395,6.0402684563758395,0,0
E00156267,113,98,61,37,0,0,10,5,5,5,5,0,0,86.72566371681415,53.98230088495575,32.743362831858406,0,0,8.849557522123893,4.424778761061947,4.424778761061947,4.424778761061947,4.424778761061947,0,0
E00156268,142,131,83,48,0,0,0,0,0,11,7,4,0,92.25352112676056,58.45070422535211,33.80281690140845,0,0,0,0,0,7.746478873239436,4.929577464788732,2.8169014084507045,0
E00156269,127,83,46,37,0,0,10,1,9,34,31,3,0,65.35433070866141,36.22047244094488,29.133858267716533,0,0,7.874015748031496,0.7874015748031495,7.086614173228346,26.77165354330709,24.409448818897637,2.3622047244094486,0
E00156270,124,84,27,57,1,1,27,4,23,12,8,4,0,67.74193548387096,21.774193548387096,45.96774193548387,0.8064516129032258,0.8064516129032258,21.774193548387096,3.225806451612903,18.548387096774192,9.67741935483871,6.451612903225806,3.225806451612903,0
E00156271,110,60,23,37,0,0,38,7,31,12,11,1,0,54.54545454545454,20.909090909090907,33.63636363636363,0,0,34.54545454545455,6.363636363636363,28.18181818181818,10.909090909090908,10,0.9090909090909091,0
E00156272,121,53,13,40,1,1,59,12,47,8,7,1,0,43.80165289256198,10.743801652892563,33.057851239669425,0.8264462809917356,0.8264462809917356,48.760330578512395,9.917355371900827,38.84297520661157,6.6115702479338845,5.785123966942149,0.8264462809917356,0
E00156273,107,52,16,36,1,1,42,5,37,12,10,2,0,48.598130841121495,14.953271028037381,33.64485981308411,0.9345794392523363,0.9345794392523363,39.25233644859813,4.672897196261682,34.57943925233645,11.214953271028037,9.345794392523365,1.8691588785046727,0
E00156274,105,75,35,40,0,0,20,1,19,10,8,2,0,71.42857142857143,33.33333333333333,38.095238095238095,0,0,19.047619047619047,0.9523809523809524,18.095238095238095,9.523809523809524,7.6190476190476195,1.9047619047619049,0
E00156275,130,88,56,32,18,18,16,0,16,8,6,2,0,67.6923076923077,43.07692307692308,24.615384615384617,13.846153846153847,13.846153846153847,12.307692307692308,0,12.307692307692308,6.153846153846154,4.615384615384616,1.5384615384615385,0
E00156276,125,60,24,36,1,1,56,1,55,8,8,0,0,48,19.2,28.799999999999997,0.8,0.8,44.800000000000004,0.8,44,6.4,6.4,0,0
E00156277,135,108,36,72,6,6,16,4,12,5,3,2,0,80,26.666666666666668,53.333333333333336,4.444444444444445,4.444444444444445,11.851851851851853,2.9629629629629632,8.88888888888889,3.7037037037037033,2.2222222222222223,1.4814814814814816,0
E00156278,113,101,47,54,0,0,6,0,6,6,4,2,0,89.38053097345133,41.5929203539823,47.78761061946903,0,0,5.3097345132743365,0,5.3097345132743365,5.3097345132743365,3.5398230088495577,1.7699115044247788,0
E00156279,133,125,69,56,0,0,2,0,2,6,6,0,0,93.98496240601504,51.8796992481203,42.10526315789473,0,0,1.5037593984962405,0,1.5037593984962405,4.511278195488721,4.511278195488721,0,0
E00156280,110,104,64,40,0,0,2,2,0,4,4,0,0,94.54545454545455,58.18181818181818,36.36363636363637,0,0,1.8181818181818181,1.8181818181818181,0,3.6363636363636362,3.6363636363636362,0,0
E00156281,127,108,64,44,0,0,1,0,1,18,15,3,0,85.03937007874016,50.39370078740157,34.645669291338585,0,0,0.7874015748031495,0,0.7874015748031495,14.173228346456693,11.811023622047244,2.3622047244094486,0
E00156282,134,90,41,49,1,1,19,3,16,24,22,2,0,67.16417910447761,30.597014925373134,36.56716417910448,0.7462686567164178,0.7462686567164178,14.17910447761194,2.2388059701492535,11.940298507462686,17.91044776119403,16.417910447761194,1.4925373134328357,0
E00170383,88,43,7,36,4,4,18,5,13,23,22,1,0,48.86363636363637,7.954545454545454,40.909090909090914,4.545454545454546,4.545454545454546,20.454545454545457,5.681818181818182,14.772727272727273,26.136363636363637,25,1.1363636363636365,0
E00170384,128,58,24,34,0,0,9,5,4,61,60,1,0,45.3125,18.75,26.5625,0,0,7.03125,3.90625,3.125,47.65625,46.875,0.78125,0
E00170385,122,33,8,25,1,1,31,3,28,57,55,2,0,27.049180327868854,6.557377049180328,20.491803278688526,0.819672131147541,0.819672131147541,25.40983606557377,2.459016393442623,22.950819672131146,46.72131147540984,45.08196721311475,1.639344262295082,0
E00170386,99,51,10,41,24,24,10,1,9,14,13,1,0,51.515151515151516,10.1010101010101,41.41414141414141,24.242424242424242,24.242424242424242,10.1010101010101,1.0101010101010102,9.090909090909092,14.14141414141414,13.131313131313133,1.0101010101010102,0
E00170387,133,71,13,58,14,14,28,1,27,20,16,4,0,53.383458646616546,9.774436090225564,43.609022556390975,10.526315789473683,10.526315789473683,21.052631578947366,0.7518796992481203,20.30075187969925,15.037593984962406,12.030075187969924,3.007518796992481,0
E00170388,179,114,26,88,3,3,25,0,25,37,36,1,0,63.687150837988824,14.52513966480447,49.162011173184354,1.675977653631285,1.675977653631285,13.966480446927374,0,13.966480446927374,20.670391061452513,20.11173184357542,0.5586592178770949,0
E00170389,106,43,12,31,6,6,30,0,30,27,26,1,0,40.56603773584906,11.320754716981133,29.245283018867923,5.660377358490567,5.660377358490567,28.30188679245283,0,28.30188679245283,25.471698113207548,24.528301886792452,0.9433962264150944,0
E00170390,112,56,9,47,13,13,10,0,10,33,33,0,0,50,8.035714285714286,41.964285714285715,11.607142857142858,11.607142857142858,8.928571428571429,0,8.928571428571429,29.464285714285715,29.464285714285715,0,0
E00170391,104,86,20,66,5,5,1,0,1,12,12,0,0,82.6923076923077,19.230769230769234,63.46153846153846,4.807692307692308,4.807692307692308,0.9615384615384616,0,0.9615384615384616,11.538461538461538,11.538461538461538,0,0
E00170392,122,82,34,48,0,0,1,0,1,39,37,2,0,67.21311475409836,27.86885245901639,39.34426229508197,0,0,0.819672131147541,0,0.819672131147541,31.967213114754102,30.327868852459016,1.639344262295082,0
E00170393,123,85,24,61,0,0,1,0,1,37,36,1,0,69.10569105691057,19.51219512195122,49.59349593495935,0,0,0.8130081300813009,0,0.8130081300813009,30.081300813008134,29.268292682926827,0.8130081300813009,0
E00170394,119,31,7,24,15,15,52,2,50,21,18,3,0,26.05042016806723,5.88235294117647,20.168067226890756,12.605042016806722,12.605042016806722,43.69747899159664,1.680672268907563,42.016806722689076,17.647058823529413,15.126050420168067,2.5210084033613445,0
E00170396,107,76,22,54,1,1,13,0,13,17,14,3,0,71.02803738317756,20.5607476635514,50.467289719626166,0.9345794392523363,0.9345794392523363,12.149532710280374,0,12.149532710280374,15.887850467289718,13.084112149532709,2.803738317757009,0
E00170397,98,77,23,54,2,2,10,1,9,9,7,2,0,78.57142857142857,23.46938775510204,55.10204081632652,2.0408163265306123,2.0408163265306123,10.204081632653061,1.0204081632653061,9.183673469387756,9.183673469387756,7.142857142857142,2.0408163265306123,0
E00170398,101,61,18,43,6,6,9,1,8,25,25,0,0,60.396039603960396,17.82178217821782,42.57425742574257,5.9405940594059405,5.9405940594059405,8.91089108910891,0.9900990099009901,7.920792079207921,24.752475247524753,24.752475247524753,0,0
E00170399,117,63,11,52,18,18,32,3,29,4,3,1,0,53.84615384615385,9.401709401709402,44.44444444444444,15.384615384615385,15.384615384615385,27.350427350427353,2.564102564102564,24.786324786324787,3.418803418803419,2.564102564102564,0.8547008547008548,0
E00170400,101,68,12,56,6,6,10,1,9,17,14,3,0,67.32673267326733,11.881188118811881,55.44554455445545,5.9405940594059405,5.9405940594059405,9.900990099009901,0.9900990099009901,8.91089108910891,16.831683168316832,13.861386138613863,2.9702970297029703,0
E00170402,103,93,32,61,0,0,3,2,1,7,4,3,0,90.29126213592234,31.06796116504854,59.22330097087378,0,0,2.912621359223301,1.9417475728155338,0.9708737864077669,6.796116504854369,3.8834951456310676,2.912621359223301,0
E00170403,62,59,43,16,0,0,0,0,0,3,3,0,0,95.16129032258065,69.35483870967742,25.806451612903224,0,0,0,0,0,4.838709677419355,4.838709677419355,0,0
E00170404,137,97,25,72,14,14,12,1,11,14,12,2,0,70.8029197080292,18.248175182481752,52.55474452554745,10.218978102189782,10.218978102189782,8.75912408759124,0.7299270072992701,8.02919708029197,10.218978102189782,8.75912408759124,1.4598540145985401,0
E00170405,170,106,36,70,8,8,34,2,32,22,21,1,0,62.35294117647059,21.176470588235293,41.17647058823529,4.705882352941177,4.705882352941177,20,1.1764705882352942,18.823529411764707,12.941176470588237,12.352941176470589,0.5882352941176471,0
E00170406,111,95,43,52,1,1,1,0,1,14,12,2,0,85.58558558558559,38.73873873873874,46.846846846846844,0.9009009009009009,0.9009009009009009,0.9009009009009009,0,0.9009009009009009,12.612612612612612,10.81081081081081,1.8018018018018018,0
E00170407,150,74,32,42,0,0,1,0,1,75,74,1,0,49.333333333333336,21.333333333333336,28.000000000000004,0,0,0.6666666666666667,0,0.6666666666666667,50,49.333333333333336,0.6666666666666667,0
E00170408,112,57,11,46,18,18,6,0,6,31,31,0,0,50.89285714285714,9.821428571428571,41.07142857142857,16.071428571428573,16.071428571428573,5.357142857142857,0,5.357142857142857,27.67857142857143,27.67857142857143,0,0
E00170409,170,99,37,62,0,0,5,1,4,66,62,4,0,58.235294117647065,21.764705882352942,36.470588235294116,0,0,2.941176470588235,0.5882352941176471,2.3529411764705883,38.82352941176471,36.470588235294116,2.3529411764705883,0
E00170410,75,72,34,38,0,0,1,0,1,2,2,0,0,96,45.33333333333333,50.66666666666667,0,0,1.3333333333333335,0,1.3333333333333335,2.666666666666667,2.666666666666667,0,0
E00170411,105,60,11,49,10,10,7,1,6,28,27,1,0,57.14285714285714,10.476190476190476,46.666666666666664,9.523809523809524,9.523809523809524,6.666666666666667,0.9523809523809524,5.714285714285714,26.666666666666668,25.71428571428571,0.9523809523809524,0
E00190475,137,23,10,13,36,36,2,0,2,76,72,4,0,16.78832116788321,7.2992700729927,9.48905109489051,26.277372262773724,26.277372262773724,1.4598540145985401,0,1.4598540145985401,55.47445255474452,52.55474452554745,2.9197080291970803,0
E00190476,122,101,14,87,6,6,14,1,13,1,1,0,0,82.78688524590164,11.475409836065573,71.31147540983606,4.918032786885246,4.918032786885246,11.475409836065573,0.819672131147541,10.655737704918032,0.819672131147541,0.819672131147541,0,0
E00190477,109,65,27,38,7,7,34,5,29,3,3,0,0,59.63302752293578,24.770642201834864,34.862385321100916,6.422018348623854,6.422018348623854,31.19266055045872,4.587155963302752,26.605504587155966,2.7522935779816518,2.7522935779816518,0,0
E00190478,119,95,31,64,1,1,4,0,4,19,17,2,0,79.83193277310924,26.05042016806723,53.78151260504202,0.8403361344537815,0.8403361344537815,3.361344537815126,0,3.361344537815126,15.966386554621847,14.285714285714285,1.680672268907563,0
E00190480,128,117,64,53,2,2,0,0,0,9,8,1,0,91.40625,50,41.40625,1.5625,1.5625,0,0,0,7.03125,6.25,0.78125,0
E00190483,140,53,12,41,2,2,13,1,12,72,68,4,0,37.857142857142854,8.571428571428571,29.28571428571429,1.4285714285714286,1.4285714285714286,9.285714285714286,0.7142857142857143,8.571428571428571,51.42857142857142,48.57142857142857,2.857142857142857,0
E00190484,139,64,18,46,11,11,43,0,43,21,19,2,0,46.043165467625904,12.949640287769784,33.093525179856115,7.913669064748201,7.913669064748201,30.935251798561154,0,30.935251798561154,15.107913669064748,13.66906474820144,1.4388489208633095,0
E00190487,144,35,12,23,4,4,3,0,3,102,99,3,0,24.305555555555554,8.333333333333332,15.972222222222221,2.7777777777777777,2.7777777777777777,2.083333333333333,0,2.083333333333333,70.83333333333334,68.75,2.083333333333333,0
E00190488,108,83,45,38,0,0,7,2,5,18,17,1,0,76.85185185185185,41.66666666666667,35.18518518518518,0,0,6.481481481481481,1.8518518518518516,4.62962962962963,16.666666666666664,15.74074074074074,0.9259259259259258,0
E00190489,122,101,35,66,9,9,4,0,4,8,7,1,0,82.78688524590164,28.688524590163933,54.09836065573771,7.377049180327869,7.377049180327869,3.278688524590164,0,3.278688524590164,6.557377049180328,5.737704918032787,0.819672131147541,0
E00190491,147,118,15,103,15,15,9,1,8,5,5,0,0,80.27210884353741,10.204081632653061,70.06802721088435,10.204081632653061,10.204081632653061,6.122448979591836,0.6802721088435374,5.442176870748299,3.4013605442176873,3.4013605442176873,0,0
E00190492,128,119,113,6,1,1,0,0,0,8,6,2,0,92.96875,88.28125,4.6875,0.78125,0.78125,0,0,0,6.25,4.6875,1.5625,0
E00190494,124,100,9,91,12,12,10,2,8,2,2,0,0,80.64516129032258,7.258064516129033,73.38709677419355,9.67741935483871,9.67741935483871,8.064516129032258,1.6129032258064515,6.451612903225806,1.6129032258064515,1.6129032258064515,0,0
E00190496,124,58,4,54,36,36,25,5,20,4,4,0,1,46.774193548387096,3.225806451612903,43.54838709677419,29.03225806451613,29.03225806451613,20.161290322580644,4.032258064516129,16.129032258064516,3.225806451612903,3.225806451612903,0,0.8064516129032258
E00190497,123,115,14,101,5,5,1,0,1,2,1,1,0,93.4959349593496,11.38211382113821,82.11382113821138,4.0650406504065035,4.0650406504065035,0.8130081300813009,0,0.8130081300813009,1.6260162601626018,0.8130081300813009,0.8130081300813009,0
E00190504,141,61,33,28,0,0,4,0,4,76,72,4,0,43.262411347517734,23.404255319148938,19.858156028368796,0,0,2.8368794326241136,0,2.8368794326241136,53.90070921985816,51.06382978723404,2.8368794326241136,0
E00190505,100,74,3,71,12,12,9,1,8,5,4,1,0,74,3,71,12,12,9,1,8,5,4,1,0
E00190507,131,5,2,3,0,0,19,3,16,101,80,21,6,3.816793893129771,1.5267175572519083,2.2900763358778624,0,0,14.50381679389313,2.2900763358778624,12.213740458015266,77.09923664122137,61.06870229007634,16.030534351145036,4.580152671755725
E00190508,142,34,13,21,0,0,19,6,13,89,81,8,0,23.943661971830984,9.15492957746479,14.788732394366196,0,0,13.380281690140844,4.225352112676056,9.15492957746479,62.676056338028175,57.04225352112676,5.633802816901409,0
E00190510,89,38,22,16,11,11,10,0,10,30,29,1,0,42.69662921348314,24.719101123595504,17.97752808988764,12.359550561797752,12.359550561797752,11.235955056179774,0,11.235955056179774,33.70786516853933,32.58426966292135,1.1235955056179776,0
E00190511,140,46,15,31,10,10,5,0,5,79,76,3,0,32.857142857142854,10.714285714285714,22.142857142857142,7.142857142857142,7.142857142857142,3.571428571428571,0,3.571428571428571,56.42857142857143,54.285714285714285,2.142857142857143,0
E00190514,77,45,40,5,4,4,10,1,9,18,17,1,0,58.44155844155844,51.94805194805194,6.493506493506493,5.194805194805195,5.194805194805195,12.987012987012985,1.2987012987012987,11.688311688311687,23.376623376623375,22.07792207792208,1.2987012987012987,0
E00190516,143,21,6,15,60,60,11,0,11,51,49,2,0,14.685314685314685,4.195804195804196,10.48951048951049,41.95804195804196,41.95804195804196,7.6923076923076925,0,7.6923076923076925,35.66433566433567,34.26573426573427,1.3986013986013985,0
E00190517,49,31,23,8,0,0,2,1,1,16,3,13,0,63.26530612244898,46.93877551020408,16.3265306122449,0,0,4.081632653061225,2.0408163265306123,2.0408163265306123,32.6530612244898,6.122448979591836,26.53061224489796,0
E00190518,117,44,9,35,35,35,32,1,31,6,6,0,0,37.60683760683761,7.6923076923076925,29.914529914529915,29.914529914529915,29.914529914529915,27.350427350427353,0.8547008547008548,26.495726495726498,5.128205128205128,5.128205128205128,0,0
E00190519,124,100,7,93,11,11,8,0,8,5,3,2,0,80.64516129032258,5.64516129032258,75,8.870967741935484,8.870967741935484,6.451612903225806,0,6.451612903225806,4.032258064516129,2.4193548387096775,1.6129032258064515,0
E00190520,128,103,15,88,11,11,6,0,6,8,6,2,0,80.46875,11.71875,68.75,8.59375,8.59375,4.6875,0,4.6875,6.25,4.6875,1.5625,0
E00190522,124,80,4,76,27,27,11,3,8,6,5,1,0,64.51612903225806,3.225806451612903,61.29032258064516,21.774193548387096,21.774193548387096,8.870967741935484,2.4193548387096775,6.451612903225806,4.838709677419355,4.032258064516129,0.8064516129032258,0
E00190523,131,124,44,80,1,1,3,0,3,3,2,1,0,94.65648854961832,33.587786259541986,61.06870229007634,0.7633587786259541,0.7633587786259541,2.2900763358778624,0,2.2900763358778624,2.2900763358778624,1.5267175572519083,0.7633587786259541,0
E00190524,135,123,20,103,0,0,0,0,0,12,11,1,0,91.11111111111111,14.814814814814813,76.29629629629629,0,0,0,0,0,8.88888888888889,8.148148148148149,0.7407407407407408,0
