OA,ts0390001,ts0390002,ts0390003,ts0390004,ts0390005,ts0390006,ts0390007,ts0390008,ts0390009,ts0390002_PCT,ts0390003_PCT,ts0390004_PCT,ts0390005_PCT,ts0390006_PCT,ts0390007_PCT,ts0390008_PCT,ts0390009_PCT
E00155864,286,265,12,8,4,4,2,2,5,92.65734265734265,4.195804195804196,2.797202797202797,1.3986013986013985,1.3986013986013985,0.6993006993006993,0.6993006993006993,1.7482517482517483
E00155865,250,228,12,10,2,3,0,3,7,91.2,4.8,4,0.8,1.2,0,1.2,2.8000000000000003
E00155866,336,304,19,16,3,4,2,2,9,90.47619047619048,5.654761904761905,4.761904761904762,0.8928571428571428,1.1904761904761905,0.5952380952380952,0.5952380952380952,2.6785714285714284
E00155867,353,333,9,7,2,4,1,3,7,94.3342776203966,2.5495750708215295,1.9830028328611897,0.56657223796034,1.13314447592068,0.28328611898017,0.84985835694051,1.9830028328611897
E00155868,346,316,12,9,3,7,3,4,11,91.32947976878613,3.4682080924855487,2.601156069364162,0.8670520231213872,2.023121387283237,0.8670520231213872,1.1560693641618496,3.1791907514450863
E00155869,258,240,11,3,8,5,2,3,2,93.02325581395348,4.263565891472868,1.1627906976744187,3.10077519379845,1.937984496124031,0.7751937984496124,1.1627906976744187,0.7751937984496124
E00155870,294,265,18,13,5,4,4,0,7,90.1360544217687,6.122448979591836,4.421768707482993,1.7006802721088436,1.3605442176870748,1.3605442176870748,0,2.380952380952381
E00155871,338,323,7,5,2,3,2,1,5,95.56213017751479,2.0710059171597637,1.4792899408284024,0.591715976331361,0.8875739644970414,0.591715976331361,0.2958579881656805,1.4792899408284024
E00155872,283,252,17,16,1,6,4,2,8,89.04593639575971,6.007067137809187,5.6537102473498235,0.35335689045936397,2.1201413427561837,1.4134275618374559,0.7067137809187279,2.8268551236749118
E00155873,358,332,14,11,3,4,1,3,8,92.73743016759776,3.910614525139665,3.072625698324022,0.8379888268156425,1.1173184357541899,0.27932960893854747,0.8379888268156425,2.2346368715083798
E00155875,320,302,13,11,2,2,0,2,3,94.375,4.0625,3.4375000000000004,0.625,0.625,0,0.625,0.9375
E00155876,326,299,18,16,2,2,0,2,7,91.71779141104295,5.521472392638037,4.9079754601226995,0.6134969325153374,0.6134969325153374,0,0.6134969325153374,2.147239263803681
E00155877,205,185,12,9,3,2,1,1,6,90.2439024390244,5.853658536585367,4.390243902439024,1.4634146341463417,0.975609756097561,0.4878048780487805,0.4878048780487805,2.9268292682926833
E00155878,260,246,10,9,1,0,0,0,4,94.61538461538461,3.8461538461538463,3.4615384615384617,0.38461538461538464,0,0,0,1.5384615384615385
E00155879,318,292,19,11,8,1,0,1,6,91.82389937106919,5.9748427672955975,3.459119496855346,2.515723270440252,0.3144654088050315,0,0.3144654088050315,1.8867924528301887
E00155880,281,254,15,12,3,7,5,2,5,90.39145907473309,5.338078291814947,4.270462633451958,1.0676156583629894,2.491103202846975,1.7793594306049825,0.7117437722419928,1.7793594306049825
E00155881,248,216,14,11,3,7,4,3,11,87.09677419354838,5.64516129032258,4.435483870967742,1.2096774193548387,2.82258064516129,1.6129032258064515,1.2096774193548387,4.435483870967742
E00155882,351,329,11,9,2,1,1,0,10,93.73219373219374,3.133903133903134,2.564102564102564,0.5698005698005698,0.2849002849002849,0.2849002849002849,0,2.849002849002849
E00155883,377,352,15,9,6,3,3,0,7,93.36870026525199,3.978779840848806,2.3872679045092835,1.5915119363395225,0.7957559681697612,0.7957559681697612,0,1.8567639257294428
E00155884,345,314,20,15,5,2,2,0,9,91.01449275362319,5.797101449275362,4.3478260869565215,1.4492753623188406,0.5797101449275363,0.5797101449275363,0,2.608695652173913
E00155885,353,326,12,10,2,7,2,5,8,92.3512747875354,3.39943342776204,2.8328611898017,0.56657223796034,1.9830028328611897,0.56657223796034,1.41643059490085,2.26628895184136
E00155886,224,205,8,8,0,1,0,1,10,91.51785714285714,3.571428571428571,3.571428571428571,0,0.4464285714285714,0,0.4464285714285714,4.464285714285714
E00155887,211,188,11,9,2,3,2,1,9,89.0995260663507,5.213270142180095,4.265402843601896,0.9478672985781991,1.4218009478672986,0.9478672985781991,0.47393364928909953,4.265402843601896
E00155888,359,327,22,13,9,1,1,0,9,91.08635097493037,6.128133704735376,3.6211699164345403,2.5069637883008355,0.2785515320334262,0.2785515320334262,0,2.5069637883008355
E00155889,463,414,29,23,6,5,2,3,15,89.41684665226782,6.263498920086392,4.967602591792657,1.2958963282937366,1.079913606911447,0.4319654427645789,0.6479481641468683,3.2397408207343417
E00155890,327,306,19,16,3,0,0,0,2,93.57798165137615,5.81039755351682,4.892966360856269,0.9174311926605505,0,0,0,0.6116207951070336
E00155891,341,309,24,21,3,2,0,2,6,90.6158357771261,7.038123167155426,6.158357771260997,0.8797653958944283,0.5865102639296188,0,0.5865102639296188,1.7595307917888565
E00155892,290,241,22,16,6,16,6,10,11,83.10344827586206,7.586206896551724,5.517241379310345,2.0689655172413794,5.517241379310345,2.0689655172413794,3.4482758620689653,3.793103448275862
E00155893,312,267,24,19,5,9,6,3,12,85.57692307692307,7.6923076923076925,6.089743589743589,1.6025641025641024,2.8846153846153846,1.9230769230769231,0.9615384615384616,3.8461538461538463
E00155894,350,317,21,20,1,7,5,2,5,90.57142857142857,6,5.714285714285714,0.2857142857142857,2,1.4285714285714286,0.5714285714285714,1.4285714285714286
E00155895,335,310,20,12,8,1,0,1,4,92.53731343283582,5.970149253731343,3.582089552238806,2.3880597014925375,0.2985074626865672,0,0.2985074626865672,1.1940298507462688
E00155896,309,285,14,12,2,3,2,1,7,92.23300970873787,4.53074433656958,3.8834951456310676,0.6472491909385114,0.9708737864077669,0.6472491909385114,0.3236245954692557,2.26537216828479
E00155897,306,278,14,11,3,9,2,7,5,90.84967320261438,4.57516339869281,3.594771241830065,0.9803921568627451,2.941176470588235,0.6535947712418301,2.287581699346405,1.6339869281045754
E00155898,313,289,19,18,1,0,0,0,5,92.33226837060703,6.070287539936102,5.7507987220447285,0.3194888178913738,0,0,0,1.5974440894568689
E00155899,125,115,7,3,4,0,0,0,3,92,5.6000000000000005,2.4,3.2,0,0,0,2.4
E00155900,275,248,21,18,3,2,2,0,4,90.18181818181819,7.636363636363637,6.545454545454546,1.090909090909091,0.7272727272727273,0.7272727272727273,0,1.4545454545454546
E00155901,294,275,14,13,1,3,2,1,2,93.5374149659864,4.761904761904762,4.421768707482993,0.3401360544217687,1.0204081632653061,0.6802721088435374,0.3401360544217687,0.6802721088435374
E00155902,308,290,12,6,6,3,2,1,3,94.15584415584416,3.896103896103896,1.948051948051948,1.948051948051948,0.974025974025974,0.6493506493506493,0.3246753246753247,0.974025974025974
E00155903,364,327,20,17,3,11,9,2,6,89.83516483516483,5.4945054945054945,4.670329670329671,0.8241758241758242,3.021978021978022,2.4725274725274726,0.5494505494505495,1.6483516483516485
E00155904,347,316,21,18,3,3,3,0,7,91.06628242074927,6.051873198847262,5.187319884726225,0.8645533141210375,0.8645533141210375,0.8645533141210375,0,2.0172910662824206
E00155906,325,290,23,17,6,2,1,1,10,89.23076923076924,7.076923076923077,5.230769230769231,1.8461538461538463,0.6153846153846154,0.3076923076923077,0.3076923076923077,3.076923076923077
E00155907,287,263,11,8,3,9,7,2,4,91.63763066202091,3.8327526132404177,2.7874564459930316,1.0452961672473868,3.1358885017421603,2.4390243902439024,0.6968641114982579,1.3937282229965158
E00155908,381,352,17,14,3,5,3,2,7,92.38845144356955,4.4619422572178475,3.674540682414698,0.7874015748031495,1.3123359580052494,0.7874015748031495,0.5249343832020997,1.837270341207349
E00155909,370,341,23,18,5,2,0,2,4,92.16216216216216,6.216216216216217,4.864864864864865,1.3513513513513513,0.5405405405405406,0,0.5405405405405406,1.0810810810810811
E00155910,322,291,11,7,4,7,5,2,13,90.37267080745342,3.4161490683229814,2.1739130434782608,1.2422360248447204,2.1739130434782608,1.5527950310559007,0.6211180124223602,4.037267080745342
E00155911,312,295,10,10,0,5,2,3,2,94.55128205128204,3.205128205128205,3.205128205128205,0,1.6025641025641024,0.641025641025641,0.9615384615384616,0.641025641025641
E00155912,298,278,16,15,1,3,2,1,1,93.28859060402685,5.369127516778524,5.033557046979865,0.33557046979865773,1.006711409395973,0.6711409395973155,0.33557046979865773,0.33557046979865773
E00155914,385,353,11,10,1,12,3,9,9,91.68831168831169,2.857142857142857,2.5974025974025974,0.2597402597402597,3.116883116883117,0.7792207792207793,2.3376623376623376,2.3376623376623376
E00155915,306,277,17,10,7,3,1,2,9,90.52287581699346,5.555555555555555,3.2679738562091507,2.287581699346405,0.9803921568627451,0.32679738562091504,0.6535947712418301,2.941176470588235
E00155916,301,278,12,11,1,3,1,2,8,92.35880398671097,3.9867109634551494,3.6544850498338874,0.33222591362126247,0.9966777408637874,0.33222591362126247,0.6644518272425249,2.6578073089700998
E00155917,305,292,7,7,0,1,0,1,5,95.73770491803279,2.2950819672131146,2.2950819672131146,0,0.32786885245901637,0,0.32786885245901637,1.639344262295082
E00155918,293,267,21,15,6,2,2,0,3,91.12627986348123,7.167235494880546,5.1194539249146755,2.04778156996587,0.6825938566552902,0.6825938566552902,0,1.023890784982935
E00155919,267,237,19,14,5,3,2,1,8,88.76404494382022,7.116104868913857,5.2434456928838955,1.8726591760299627,1.1235955056179776,0.7490636704119851,0.37453183520599254,2.9962546816479403
E00155920,325,292,15,12,3,9,5,4,9,89.84615384615384,4.615384615384616,3.6923076923076925,0.9230769230769231,2.769230769230769,1.5384615384615385,1.2307692307692308,2.769230769230769
E00155921,271,253,7,5,2,6,3,3,5,93.35793357933579,2.5830258302583027,1.8450184501845017,0.7380073800738007,2.214022140221402,1.107011070110701,1.107011070110701,1.8450184501845017
E00155922,301,277,8,4,4,6,5,1,10,92.02657807308971,2.6578073089700998,1.3289036544850499,1.3289036544850499,1.9933554817275747,1.6611295681063125,0.33222591362126247,3.322259136212625
E00155923,320,302,15,12,3,2,0,2,1,94.375,4.6875,3.75,0.9375,0.625,0,0.625,0.3125
E00155924,255,239,6,5,1,5,2,3,5,93.72549019607843,2.3529411764705883,1.9607843137254901,0.39215686274509803,1.9607843137254901,0.7843137254901961,1.1764705882352942,1.9607843137254901
E00155925,291,271,9,8,1,3,1,2,8,93.12714776632302,3.0927835051546393,2.7491408934707904,0.3436426116838488,1.0309278350515463,0.3436426116838488,0.6872852233676976,2.7491408934707904
E00155926,301,279,17,17,0,1,1,0,4,92.69102990033223,5.647840531561462,5.647840531561462,0,0.33222591362126247,0.33222591362126247,0,1.3289036544850499
E00155927,278,264,8,6,2,4,3,1,2,94.96402877697841,2.877697841726619,2.158273381294964,0.7194244604316548,1.4388489208633095,1.079136690647482,0.3597122302158274,0.7194244604316548
E00155928,342,318,13,8,5,4,1,3,7,92.98245614035088,3.8011695906432745,2.3391812865497075,1.461988304093567,1.1695906432748537,0.29239766081871343,0.8771929824561403,2.046783625730994
E00155929,322,308,11,8,3,0,0,0,3,95.65217391304348,3.4161490683229814,2.484472049689441,0.9316770186335404,0,0,0,0.9316770186335404
E00155930,203,189,8,6,2,1,1,0,5,93.10344827586206,3.9408866995073892,2.955665024630542,0.9852216748768473,0.49261083743842365,0.49261083743842365,0,2.4630541871921183
E00155931,344,321,18,14,4,3,3,0,2,93.31395348837209,5.232558139534884,4.069767441860465,1.1627906976744187,0.872093023255814,0.872093023255814,0,0.5813953488372093
E00155932,331,294,13,9,4,6,3,3,18,88.82175226586104,3.927492447129909,2.719033232628399,1.2084592145015105,1.812688821752266,0.906344410876133,0.906344410876133,5.438066465256798
E00155933,337,305,14,10,4,4,2,2,14,90.50445103857567,4.154302670623145,2.967359050445104,1.1869436201780417,1.1869436201780417,0.5934718100890208,0.5934718100890208,4.154302670623145
E00155934,350,315,20,15,5,4,3,1,11,90,5.714285714285714,4.285714285714286,1.4285714285714286,1.1428571428571428,0.8571428571428572,0.2857142857142857,3.1428571428571432
E00155935,326,304,15,9,6,0,0,0,7,93.25153374233128,4.601226993865031,2.7607361963190185,1.8404907975460123,0,0,0,2.147239263803681
E00155936,302,276,14,13,1,1,1,0,11,91.3907284768212,4.635761589403973,4.304635761589404,0.33112582781456956,0.33112582781456956,0.33112582781456956,0,3.642384105960265
E00155937,263,235,14,12,2,7,3,4,7,89.35361216730038,5.323193916349809,4.562737642585551,0.7604562737642585,2.6615969581749046,1.1406844106463878,1.520912547528517,2.6615969581749046
E00155938,400,370,15,11,4,8,3,5,7,92.5,3.75,2.75,1,2,0.75,1.25,1.7500000000000002
E00155940,303,287,9,8,1,5,2,3,2,94.71947194719472,2.9702970297029703,2.6402640264026402,0.33003300330033003,1.65016501650165,0.6600660066006601,0.9900990099009901,0.6600660066006601
E00155941,304,272,16,6,10,5,4,1,11,89.47368421052632,5.263157894736842,1.9736842105263157,3.289473684210526,1.644736842105263,1.3157894736842104,0.3289473684210526,3.618421052631579
E00155942,246,232,2,0,2,9,5,4,3,94.3089430894309,0.8130081300813009,0,0.8130081300813009,3.6585365853658534,2.0325203252032518,1.6260162601626018,1.2195121951219512
E00155943,360,323,17,10,7,5,2,3,15,89.72222222222223,4.722222222222222,2.7777777777777777,1.9444444444444444,1.3888888888888888,0.5555555555555556,0.8333333333333334,4.166666666666666
E00155944,307,259,18,14,4,18,7,11,12,84.36482084690554,5.863192182410423,4.5602605863192185,1.3029315960912053,5.863192182410423,2.2801302931596092,3.5830618892508146,3.908794788273615
E00155945,271,249,11,8,3,3,2,1,8,91.88191881918819,4.059040590405904,2.952029520295203,1.107011070110701,1.107011070110701,0.7380073800738007,0.36900369003690037,2.952029520295203
E00155946,259,234,11,7,4,7,1,6,7,90.34749034749035,4.247104247104247,2.7027027027027026,1.5444015444015444,2.7027027027027026,0.3861003861003861,2.3166023166023164,2.7027027027027026
E00155947,242,230,4,3,1,3,3,0,5,95.0413223140496,1.6528925619834711,1.2396694214876034,0.4132231404958678,1.2396694214876034,1.2396694214876034,0,2.066115702479339
E00155948,220,203,3,3,0,3,0,3,11,92.27272727272727,1.3636363636363635,1.3636363636363635,0,1.3636363636363635,0,1.3636363636363635,5
E00155949,310,277,18,11,7,6,3,3,9,89.35483870967742,5.806451612903226,3.5483870967741935,2.258064516129032,1.935483870967742,0.967741935483871,0.967741935483871,2.903225806451613
E00155950,235,209,10,10,0,5,1,4,11,88.93617021276596,4.25531914893617,4.25531914893617,0,2.127659574468085,0.425531914893617,1.702127659574468,4.680851063829787
E00155951,297,266,10,7,3,8,5,3,13,89.56228956228956,3.3670033670033668,2.356902356902357,1.0101010101010102,2.6936026936026933,1.6835016835016834,1.0101010101010102,4.377104377104377
E00155952,242,235,6,5,1,1,1,0,0,97.10743801652893,2.479338842975207,2.066115702479339,0.4132231404958678,0.4132231404958678,0.4132231404958678,0,0
E00155953,351,329,8,7,1,5,2,3,9,93.73219373219374,2.2792022792022792,1.9943019943019942,0.2849002849002849,1.4245014245014245,0.5698005698005698,0.8547008547008548,2.564102564102564
E00155954,357,319,23,17,6,10,4,6,5,89.35574229691878,6.442577030812324,4.761904761904762,1.680672268907563,2.801120448179272,1.1204481792717087,1.680672268907563,1.400560224089636
E00155955,353,338,7,6,1,5,1,4,3,95.75070821529745,1.9830028328611897,1.69971671388102,0.28328611898017,1.41643059490085,0.28328611898017,1.13314447592068,0.84985835694051
E00155956,226,213,8,7,1,1,1,0,4,94.24778761061947,3.5398230088495577,3.0973451327433628,0.4424778761061947,0.4424778761061947,0.4424778761061947,0,1.7699115044247788
E00155957,299,272,12,10,2,5,2,3,10,90.96989966555184,4.013377926421405,3.3444816053511706,0.6688963210702341,1.6722408026755853,0.6688963210702341,1.0033444816053512,3.3444816053511706
E00155958,255,239,8,8,0,3,0,3,5,93.72549019607843,3.1372549019607843,3.1372549019607843,0,1.1764705882352942,0,1.1764705882352942,1.9607843137254901
E00155959,289,268,13,8,5,5,2,3,3,92.73356401384083,4.498269896193772,2.768166089965398,1.7301038062283738,1.7301038062283738,0.6920415224913495,1.0380622837370241,1.0380622837370241
E00155961,256,241,9,9,0,3,3,0,3,94.140625,3.515625,3.515625,0,1.171875,1.171875,0,1.171875
E00155962,212,198,6,6,0,2,1,1,6,93.39622641509435,2.8301886792452833,2.8301886792452833,0,0.9433962264150944,0.4716981132075472,0.4716981132075472,2.8301886792452833
E00155963,268,241,14,12,2,3,2,1,10,89.92537313432835,5.223880597014925,4.477611940298507,0.7462686567164178,1.1194029850746268,0.7462686567164178,0.3731343283582089,3.731343283582089
E00155964,261,235,20,11,9,5,2,3,1,90.03831417624522,7.662835249042145,4.21455938697318,3.4482758620689653,1.9157088122605364,0.7662835249042145,1.1494252873563218,0.38314176245210724
E00155965,334,319,7,5,2,1,0,1,7,95.50898203592814,2.095808383233533,1.4970059880239521,0.5988023952095809,0.29940119760479045,0,0.29940119760479045,2.095808383233533
E00155966,337,313,13,9,4,3,2,1,8,92.87833827893175,3.857566765578635,2.6706231454005933,1.1869436201780417,0.8902077151335311,0.5934718100890208,0.2967359050445104,2.3738872403560833
E00155967,381,349,25,20,5,0,0,0,7,91.60104986876641,6.561679790026247,5.2493438320209975,1.3123359580052494,0,0,0,1.837270341207349
E00155968,291,273,9,9,0,2,1,1,7,93.81443298969072,3.0927835051546393,3.0927835051546393,0,0.6872852233676976,0.3436426116838488,0.3436426116838488,2.405498281786942
E00155969,306,285,14,11,3,3,3,0,4,93.13725490196079,4.57516339869281,3.594771241830065,0.9803921568627451,0.9803921568627451,0.9803921568627451,0,1.3071895424836601
E00155970,360,327,22,18,4,7,2,5,4,90.83333333333333,6.111111111111111,5,1.1111111111111112,1.9444444444444444,0.5555555555555556,1.3888888888888888,1.1111111111111112
E00155971,243,227,11,8,3,2,1,1,3,93.4156378600823,4.526748971193416,3.292181069958848,1.2345679012345678,0.823045267489712,0.411522633744856,0.411522633744856,1.2345679012345678
E00155972,249,223,14,11,3,4,2,2,8,89.5582329317269,5.622489959839357,4.417670682730924,1.2048192771084338,1.6064257028112447,0.8032128514056224,0.8032128514056224,3.2128514056224895
E00155975,192,182,7,7,0,1,1,0,2,94.79166666666666,3.6458333333333335,3.6458333333333335,0,0.5208333333333333,0.5208333333333333,0,1.0416666666666665
E00155976,262,246,9,8,1,3,2,1,4,93.89312977099237,3.435114503816794,3.0534351145038165,0.38167938931297707,1.1450381679389312,0.7633587786259541,0.38167938931297707,1.5267175572519083
E00155977,251,232,13,13,0,5,2,3,1,92.43027888446214,5.179282868525896,5.179282868525896,0,1.9920318725099602,0.796812749003984,1.1952191235059761,0.398406374501992
E00155978,230,225,2,1,1,2,1,1,1,97.82608695652173,0.8695652173913043,0.43478260869565216,0.43478260869565216,0.8695652173913043,0.43478260869565216,0.43478260869565216,0.43478260869565216
E00155979,278,259,11,5,6,3,2,1,5,93.16546762589928,3.9568345323741005,1.7985611510791366,2.158273381294964,1.079136690647482,0.7194244604316548,0.3597122302158274,1.7985611510791366
E00155980,472,435,18,16,2,6,0,6,13,92.16101694915254,3.8135593220338984,3.389830508474576,0.423728813559322,1.2711864406779663,0,1.2711864406779663,2.754237288135593
E00155981,329,301,16,11,5,5,2,3,7,91.48936170212765,4.86322188449848,3.343465045592705,1.5197568389057752,1.5197568389057752,0.60790273556231,0.911854103343465,2.127659574468085
E00155982,325,282,19,14,5,11,3,8,13,86.76923076923076,5.846153846153846,4.3076923076923075,1.5384615384615385,3.3846153846153846,0.9230769230769231,2.4615384615384617,4
E00155983,292,252,17,13,4,9,5,4,14,86.3013698630137,5.821917808219178,4.4520547945205475,1.36986301369863,3.0821917808219177,1.7123287671232876,1.36986301369863,4.794520547945205
E00155984,374,337,24,17,7,4,3,1,9,90.10695187165776,6.417112299465241,4.545454545454546,1.8716577540106951,1.06951871657754,0.8021390374331552,0.267379679144385,2.406417112299465
E00155985,289,267,14,10,4,4,2,2,4,92.38754325259517,4.844290657439446,3.4602076124567476,1.384083044982699,1.384083044982699,0.6920415224913495,0.6920415224913495,1.384083044982699
E00155986,267,221,28,17,11,7,3,4,11,82.77153558052434,10.486891385767791,6.367041198501873,4.119850187265917,2.6217228464419478,1.1235955056179776,1.4981273408239701,4.119850187265917
E00155987,299,278,14,8,6,4,0,4,3,92.97658862876254,4.682274247491638,2.6755852842809364,2.0066889632107023,1.3377926421404682,0,1.3377926421404682,1.0033444816053512
E00155988,262,232,14,12,2,6,2,4,10,88.54961832061069,5.343511450381679,4.580152671755725,0.7633587786259541,2.2900763358778624,0.7633587786259541,1.5267175572519083,3.816793893129771
E00155989,341,298,15,10,5,11,5,6,17,87.3900293255132,4.398826979472141,2.932551319648094,1.466275659824047,3.225806451612903,1.466275659824047,1.7595307917888565,4.9853372434017595
E00155990,290,263,14,10,4,6,1,5,7,90.6896551724138,4.827586206896552,3.4482758620689653,1.3793103448275863,2.0689655172413794,0.3448275862068966,1.7241379310344827,2.413793103448276
E00155991,271,238,15,12,3,12,5,7,6,87.82287822878229,5.535055350553505,4.428044280442804,1.107011070110701,4.428044280442804,1.8450184501845017,2.5830258302583027,2.214022140221402
E00155992,259,238,14,11,3,3,1,2,4,91.8918918918919,5.405405405405405,4.247104247104247,1.1583011583011582,1.1583011583011582,0.3861003861003861,0.7722007722007722,1.5444015444015444
E00155993,265,242,15,10,5,2,1,1,6,91.32075471698113,5.660377358490567,3.7735849056603774,1.8867924528301887,0.7547169811320755,0.37735849056603776,0.37735849056603776,2.2641509433962264
E00155994,265,239,13,10,3,9,5,4,4,90.18867924528303,4.905660377358491,3.7735849056603774,1.1320754716981132,3.3962264150943398,1.8867924528301887,1.509433962264151,1.509433962264151
E00155996,320,297,11,8,3,8,6,2,4,92.8125,3.4375000000000004,2.5,0.9375,2.5,1.875,0.625,1.25
E00155997,298,277,17,15,2,1,1,0,3,92.9530201342282,5.704697986577181,5.033557046979865,0.6711409395973155,0.33557046979865773,0.33557046979865773,0,1.006711409395973
E00155998,423,382,16,7,9,13,5,8,12,90.30732860520094,3.7825059101654848,1.6548463356973995,2.127659574468085,3.0732860520094563,1.1820330969267139,1.8912529550827424,2.8368794326241136
E00155999,324,292,21,18,3,1,0,1,10,90.12345679012346,6.481481481481481,5.555555555555555,0.9259259259259258,0.30864197530864196,0,0.30864197530864196,3.0864197530864197
E00156000,268,238,7,3,4,8,5,3,15,88.80597014925374,2.6119402985074625,1.1194029850746268,1.4925373134328357,2.9850746268656714,1.8656716417910446,1.1194029850746268,5.597014925373134
E00156001,333,317,7,3,4,3,1,2,6,95.1951951951952,2.1021021021021022,0.9009009009009009,1.2012012012012012,0.9009009009009009,0.3003003003003003,0.6006006006006006,1.8018018018018018
E00156002,257,240,8,5,3,3,0,3,6,93.3852140077821,3.11284046692607,1.9455252918287937,1.1673151750972763,1.1673151750972763,0,1.1673151750972763,2.3346303501945527
E00156003,399,364,16,11,5,8,6,2,11,91.22807017543859,4.010025062656641,2.756892230576441,1.2531328320802004,2.0050125313283207,1.5037593984962405,0.5012531328320802,2.756892230576441
E00156004,309,288,10,7,3,4,3,1,7,93.20388349514563,3.2362459546925564,2.26537216828479,0.9708737864077669,1.2944983818770228,0.9708737864077669,0.3236245954692557,2.26537216828479
E00156005,363,346,7,6,1,3,0,3,7,95.31680440771349,1.9283746556473829,1.6528925619834711,0.27548209366391185,0.8264462809917356,0,0.8264462809917356,1.9283746556473829
E00156006,318,274,28,23,5,7,5,2,9,86.16352201257862,8.80503144654088,7.232704402515723,1.5723270440251573,2.20125786163522,1.5723270440251573,0.628930817610063,2.8301886792452833
E00156007,237,221,10,8,2,3,1,2,3,93.24894514767934,4.219409282700422,3.375527426160337,0.8438818565400843,1.2658227848101267,0.42194092827004215,0.8438818565400843,1.2658227848101267
E00156008,326,298,14,8,6,2,1,1,12,91.41104294478528,4.294478527607362,2.4539877300613497,1.8404907975460123,0.6134969325153374,0.3067484662576687,0.3067484662576687,3.6809815950920246
E00156009,344,319,13,12,1,6,3,3,6,92.73255813953489,3.77906976744186,3.488372093023256,0.29069767441860467,1.744186046511628,0.872093023255814,0.872093023255814,1.744186046511628
E00156012,315,278,20,18,2,10,5,5,7,88.25396825396825,6.349206349206349,5.714285714285714,0.6349206349206349,3.1746031746031744,1.5873015873015872,1.5873015873015872,2.2222222222222223
E00156013,352,329,12,10,2,4,1,3,7,93.4659090909091,3.4090909090909087,2.840909090909091,0.5681818181818182,1.1363636363636365,0.2840909090909091,0.8522727272727272,1.9886363636363635
E00156014,334,302,20,13,7,5,1,4,7,90.41916167664671,5.9880239520958085,3.8922155688622757,2.095808383233533,1.4970059880239521,0.29940119760479045,1.1976047904191618,2.095808383233533
E00156015,341,308,15,7,8,3,3,0,15,90.32258064516128,4.398826979472141,2.0527859237536656,2.346041055718475,0.8797653958944283,0.8797653958944283,0,4.398826979472141
E00156016,393,346,29,20,9,7,1,6,11,88.04071246819338,7.37913486005089,5.089058524173027,2.2900763358778624,1.7811704834605597,0.2544529262086514,1.5267175572519083,2.7989821882951653
E00156017,409,378,18,13,5,2,1,1,11,92.42053789731052,4.400977995110025,3.1784841075794623,1.2224938875305624,0.4889975550122249,0.24449877750611246,0.24449877750611246,2.689486552567237
E00156018,300,271,16,11,5,4,2,2,9,90.33333333333333,5.333333333333334,3.6666666666666665,1.6666666666666667,1.3333333333333335,0.6666666666666667,0.6666666666666667,3
E00156019,470,436,18,13,5,9,7,2,7,92.76595744680851,3.829787234042553,2.7659574468085104,1.0638297872340425,1.9148936170212765,1.4893617021276597,0.425531914893617,1.4893617021276597
E00156020,307,279,20,18,2,1,0,1,7,90.87947882736157,6.514657980456026,5.863192182410423,0.6514657980456027,0.32573289902280134,0,0.32573289902280134,2.2801302931596092
E00156021,443,412,22,17,5,1,0,1,8,93.00225733634312,4.966139954853273,3.837471783295711,1.1286681715575622,0.2257336343115124,0,0.2257336343115124,1.805869074492099
E00156022,332,310,14,11,3,3,1,2,5,93.37349397590361,4.216867469879518,3.313253012048193,0.9036144578313252,0.9036144578313252,0.30120481927710846,0.6024096385542169,1.5060240963855422
E00156023,329,313,7,3,4,2,1,1,7,95.13677811550151,2.127659574468085,0.911854103343465,1.21580547112462,0.60790273556231,0.303951367781155,0.303951367781155,2.127659574468085
E00156024,391,353,25,22,3,9,2,7,4,90.28132992327366,6.3938618925831205,5.626598465473146,0.7672634271099744,2.3017902813299234,0.5115089514066496,1.7902813299232736,1.0230179028132993
E00156025,330,312,10,7,3,3,2,1,5,94.54545454545455,3.0303030303030303,2.1212121212121215,0.9090909090909091,0.9090909090909091,0.6060606060606061,0.30303030303030304,1.5151515151515151
E00156026,476,448,19,11,8,4,0,4,5,94.11764705882352,3.9915966386554618,2.3109243697478994,1.680672268907563,0.8403361344537815,0,0.8403361344537815,1.050420168067227
E00156027,340,310,21,14,7,6,2,4,3,91.17647058823529,6.176470588235294,4.117647058823529,2.0588235294117645,1.7647058823529411,0.5882352941176471,1.1764705882352942,0.8823529411764706
E00156028,280,259,14,13,1,2,1,1,5,92.5,5,4.642857142857143,0.35714285714285715,0.7142857142857143,0.35714285714285715,0.35714285714285715,1.7857142857142856
E00156029,283,267,8,8,0,4,2,2,4,94.34628975265018,2.8268551236749118,2.8268551236749118,0,1.4134275618374559,0.7067137809187279,0.7067137809187279,1.4134275618374559
E00156030,358,339,12,10,2,4,2,2,3,94.6927374301676,3.35195530726257,2.793296089385475,0.5586592178770949,1.1173184357541899,0.5586592178770949,0.5586592178770949,0.8379888268156425
E00156031,343,321,19,14,5,2,2,0,1,93.58600583090379,5.539358600583091,4.081632653061225,1.4577259475218658,0.5830903790087464,0.5830903790087464,0,0.2915451895043732
E00156032,321,290,18,14,4,6,3,3,7,90.34267912772586,5.607476635514018,4.361370716510903,1.2461059190031152,1.8691588785046727,0.9345794392523363,0.9345794392523363,2.1806853582554515
E00156033,385,357,20,18,2,1,0,1,7,92.72727272727272,5.194805194805195,4.675324675324675,0.5194805194805194,0.2597402597402597,0,0.2597402597402597,1.8181818181818181
E00156034,299,288,6,6,0,4,3,1,1,96.32107023411372,2.0066889632107023,2.0066889632107023,0,1.3377926421404682,1.0033444816053512,0.33444816053511706,0.33444816053511706
E00156035,365,344,11,9,2,6,3,3,4,94.24657534246576,3.0136986301369864,2.4657534246575343,0.547945205479452,1.643835616438356,0.821917808219178,0.821917808219178,1.095890410958904
E00156036,227,215,7,7,0,4,0,4,1,94.7136563876652,3.0837004405286343,3.0837004405286343,0,1.762114537444934,0,1.762114537444934,0.4405286343612335
E00156037,322,308,11,10,1,0,0,0,3,95.65217391304348,3.4161490683229814,3.1055900621118013,0.3105590062111801,0,0,0,0.9316770186335404
E00156038,382,357,15,14,1,2,2,0,8,93.45549738219894,3.926701570680628,3.664921465968586,0.2617801047120419,0.5235602094240838,0.5235602094240838,0,2.094240837696335
E00156039,349,331,14,11,3,2,1,1,2,94.84240687679083,4.011461318051576,3.151862464183381,0.8595988538681949,0.5730659025787965,0.28653295128939826,0.28653295128939826,0.5730659025787965
E00156040,257,237,11,9,2,4,1,3,5,92.21789883268482,4.280155642023346,3.501945525291829,0.7782101167315175,1.556420233463035,0.38910505836575876,1.1673151750972763,1.9455252918287937
E00156041,407,368,15,10,5,5,0,5,19,90.41769041769042,3.6855036855036856,2.457002457002457,1.2285012285012284,1.2285012285012284,0,1.2285012285012284,4.668304668304668
E00156042,348,323,17,13,4,1,1,0,7,92.81609195402298,4.885057471264368,3.7356321839080464,1.1494252873563218,0.28735632183908044,0.28735632183908044,0,2.0114942528735633
E00156043,281,256,18,16,2,3,1,2,4,91.10320284697508,6.405693950177936,5.6939501779359425,0.7117437722419928,1.0676156583629894,0.3558718861209964,0.7117437722419928,1.4234875444839856
E00156044,314,290,11,11,0,4,3,1,9,92.35668789808918,3.5031847133757963,3.5031847133757963,0,1.2738853503184715,0.9554140127388535,0.3184713375796179,2.8662420382165608
E00156045,353,321,8,8,0,8,5,3,16,90.93484419263456,2.26628895184136,2.26628895184136,0,2.26628895184136,1.41643059490085,0.84985835694051,4.53257790368272
E00156046,285,267,13,10,3,1,0,1,4,93.6842105263158,4.56140350877193,3.508771929824561,1.0526315789473684,0.3508771929824561,0,0.3508771929824561,1.4035087719298245
E00156047,302,278,11,11,0,7,2,5,6,92.05298013245033,3.642384105960265,3.642384105960265,0,2.3178807947019866,0.6622516556291391,1.6556291390728477,1.9867549668874174
E00156048,321,290,16,14,2,11,7,4,4,90.34267912772586,4.984423676012461,4.361370716510903,0.6230529595015576,3.4267912772585665,2.1806853582554515,1.2461059190031152,1.2461059190031152
E00156049,423,396,21,20,1,1,1,0,5,93.61702127659575,4.964539007092199,4.7281323877068555,0.2364066193853428,0.2364066193853428,0.2364066193853428,0,1.1820330969267139
E00156050,319,297,17,13,4,3,0,3,2,93.10344827586206,5.329153605015674,4.075235109717868,1.2539184952978055,0.9404388714733543,0,0.9404388714733543,0.6269592476489028
E00156051,277,254,10,8,2,6,3,3,7,91.69675090252709,3.6101083032490973,2.888086642599278,0.7220216606498195,2.166064981949458,1.083032490974729,1.083032490974729,2.527075812274368
E00156052,268,247,5,5,0,5,4,1,11,92.16417910447761,1.8656716417910446,1.8656716417910446,0,1.8656716417910446,1.4925373134328357,0.3731343283582089,4.104477611940299
E00156053,336,308,14,13,1,4,2,2,10,91.66666666666666,4.166666666666666,3.869047619047619,0.2976190476190476,1.1904761904761905,0.5952380952380952,0.5952380952380952,2.976190476190476
E00156054,376,341,26,19,7,6,4,2,3,90.69148936170212,6.914893617021277,5.053191489361701,1.8617021276595744,1.5957446808510638,1.0638297872340425,0.5319148936170213,0.7978723404255319
E00156055,328,306,11,9,2,4,3,1,7,93.29268292682927,3.353658536585366,2.7439024390243905,0.6097560975609756,1.2195121951219512,0.9146341463414633,0.3048780487804878,2.1341463414634148
E00156056,391,367,10,8,2,10,5,5,4,93.86189258312021,2.557544757033248,2.0460358056265986,0.5115089514066496,2.557544757033248,1.278772378516624,1.278772378516624,1.0230179028132993
E00156057,377,336,17,11,6,9,4,5,15,89.12466843501326,4.509283819628647,2.9177718832891246,1.5915119363395225,2.3872679045092835,1.0610079575596816,1.3262599469496021,3.978779840848806
E00156058,298,274,15,10,5,4,2,2,5,91.94630872483222,5.033557046979865,3.3557046979865772,1.6778523489932886,1.342281879194631,0.6711409395973155,0.6711409395973155,1.6778523489932886
E00156059,308,285,11,6,5,7,4,3,5,92.53246753246754,3.571428571428571,1.948051948051948,1.6233766233766231,2.272727272727273,1.2987012987012987,0.974025974025974,1.6233766233766231
E00156060,192,177,6,4,2,0,0,0,9,92.1875,3.125,2.083333333333333,1.0416666666666665,0,0,0,4.6875
E00156061,296,271,8,7,1,5,3,2,12,91.55405405405406,2.7027027027027026,2.364864864864865,0.33783783783783783,1.6891891891891893,1.0135135135135136,0.6756756756756757,4.054054054054054
E00156062,290,260,11,8,3,10,5,5,9,89.65517241379311,3.793103448275862,2.7586206896551726,1.0344827586206897,3.4482758620689653,1.7241379310344827,1.7241379310344827,3.103448275862069
E00156063,310,290,13,10,3,6,3,3,1,93.54838709677419,4.193548387096775,3.225806451612903,0.967741935483871,1.935483870967742,0.967741935483871,0.967741935483871,0.3225806451612903
E00156064,318,293,14,11,3,3,2,1,8,92.13836477987421,4.40251572327044,3.459119496855346,0.9433962264150944,0.9433962264150944,0.628930817610063,0.3144654088050315,2.515723270440252
E00156065,354,328,16,10,6,3,2,1,7,92.65536723163842,4.519774011299435,2.824858757062147,1.694915254237288,0.847457627118644,0.5649717514124294,0.2824858757062147,1.977401129943503
E00156066,287,266,7,5,2,5,2,3,9,92.6829268292683,2.4390243902439024,1.7421602787456445,0.6968641114982579,1.7421602787456445,0.6968641114982579,1.0452961672473868,3.1358885017421603
E00156067,340,314,14,11,3,3,2,1,9,92.3529411764706,4.117647058823529,3.2352941176470593,0.8823529411764706,0.8823529411764706,0.5882352941176471,0.29411764705882354,2.6470588235294117
E00156068,298,278,7,6,1,5,3,2,8,93.28859060402685,2.348993288590604,2.013422818791946,0.33557046979865773,1.6778523489932886,1.006711409395973,0.6711409395973155,2.684563758389262
E00156069,304,281,8,5,3,5,4,1,10,92.43421052631578,2.631578947368421,1.644736842105263,0.9868421052631579,1.644736842105263,1.3157894736842104,0.3289473684210526,3.289473684210526
E00156070,293,266,13,8,5,6,5,1,8,90.78498293515358,4.436860068259386,2.7303754266211606,1.7064846416382253,2.04778156996587,1.7064846416382253,0.3412969283276451,2.7303754266211606
E00156071,289,255,18,14,4,9,4,5,7,88.23529411764706,6.228373702422145,4.844290657439446,1.384083044982699,3.1141868512110724,1.384083044982699,1.7301038062283738,2.422145328719723
E00156072,342,309,9,8,1,11,4,7,13,90.35087719298247,2.631578947368421,2.3391812865497075,0.29239766081871343,3.216374269005848,1.1695906432748537,2.046783625730994,3.8011695906432745
E00156073,396,366,12,9,3,7,3,4,11,92.42424242424242,3.0303030303030303,2.272727272727273,0.7575757575757576,1.7676767676767675,0.7575757575757576,1.0101010101010102,2.7777777777777777
E00156074,327,299,11,8,3,5,0,5,12,91.43730886850153,3.3639143730886847,2.4464831804281344,0.9174311926605505,1.529051987767584,0,1.529051987767584,3.669724770642202
E00156075,355,323,20,16,4,4,2,2,8,90.98591549295774,5.633802816901409,4.507042253521127,1.1267605633802817,1.1267605633802817,0.5633802816901409,0.5633802816901409,2.2535211267605635
E00156076,204,180,17,15,2,7,4,3,0,88.23529411764706,8.333333333333332,7.352941176470589,0.9803921568627451,3.431372549019608,1.9607843137254901,1.4705882352941175,0
E00156077,356,333,9,8,1,7,5,2,7,93.53932584269663,2.528089887640449,2.247191011235955,0.2808988764044944,1.9662921348314606,1.4044943820224718,0.5617977528089888,1.9662921348314606
E00156078,350,322,17,13,4,2,1,1,9,92,4.857142857142857,3.7142857142857144,1.1428571428571428,0.5714285714285714,0.2857142857142857,0.2857142857142857,2.571428571428571
E00156079,355,317,29,27,2,2,0,2,7,89.29577464788733,8.169014084507042,7.605633802816901,0.5633802816901409,0.5633802816901409,0,0.5633802816901409,1.971830985915493
E00156080,337,306,24,20,4,5,3,2,2,90.80118694362018,7.121661721068249,5.934718100890208,1.1869436201780417,1.483679525222552,0.8902077151335311,0.5934718100890208,0.5934718100890208
E00156081,383,356,18,15,3,3,2,1,6,92.95039164490862,4.699738903394255,3.91644908616188,0.7832898172323759,0.7832898172323759,0.5221932114882507,0.26109660574412535,1.5665796344647518
E00156082,377,353,16,11,5,6,3,3,2,93.63395225464191,4.244031830238726,2.9177718832891246,1.3262599469496021,1.5915119363395225,0.7957559681697612,0.7957559681697612,0.5305039787798408
E00156083,359,323,22,18,4,8,5,3,6,89.97214484679665,6.128133704735376,5.013927576601671,1.1142061281337048,2.2284122562674096,1.392757660167131,0.8356545961002786,1.6713091922005572
E00156084,396,365,16,14,2,6,3,3,9,92.17171717171718,4.040404040404041,3.535353535353535,0.5050505050505051,1.5151515151515151,0.7575757575757576,0.7575757575757576,2.272727272727273
E00156085,354,317,25,18,7,4,3,1,8,89.54802259887006,7.062146892655368,5.084745762711865,1.977401129943503,1.1299435028248588,0.847457627118644,0.2824858757062147,2.2598870056497176
E00156086,503,465,16,11,5,1,1,0,21,92.44532803180915,3.180914512922465,2.1868787276341948,0.9940357852882704,0.19880715705765406,0.19880715705765406,0,4.174950298210735
E00156087,585,534,35,23,12,9,4,5,7,91.28205128205128,5.982905982905983,3.9316239316239314,2.051282051282051,1.5384615384615385,0.6837606837606838,0.8547008547008548,1.1965811965811968
E00156088,302,271,17,13,4,9,2,7,5,89.73509933774835,5.629139072847682,4.304635761589404,1.3245033112582782,2.980132450331126,0.6622516556291391,2.3178807947019866,1.6556291390728477
E00156089,403,367,21,15,6,7,4,3,8,91.06699751861042,5.2109181141439205,3.722084367245657,1.488833746898263,1.7369727047146404,0.9925558312655087,0.7444168734491315,1.9851116625310175
E00156090,277,235,24,17,7,4,2,2,14,84.83754512635379,8.664259927797833,6.137184115523466,2.527075812274368,1.444043321299639,0.7220216606498195,0.7220216606498195,5.054151624548736
E00156091,394,367,14,10,4,7,1,6,6,93.1472081218274,3.5532994923857872,2.5380710659898478,1.015228426395939,1.7766497461928936,0.25380710659898476,1.5228426395939088,1.5228426395939088
E00156092,246,225,10,9,1,4,3,1,7,91.46341463414635,4.0650406504065035,3.6585365853658534,0.40650406504065045,1.6260162601626018,1.2195121951219512,0.40650406504065045,2.8455284552845526
E00156093,290,271,10,8,2,3,2,1,6,93.44827586206897,3.4482758620689653,2.7586206896551726,0.6896551724137931,1.0344827586206897,0.6896551724137931,0.3448275862068966,2.0689655172413794
E00156094,309,297,6,4,2,1,1,0,5,96.11650485436894,1.9417475728155338,1.2944983818770228,0.6472491909385114,0.3236245954692557,0.3236245954692557,0,1.6181229773462782
E00156095,347,312,24,21,3,3,1,2,8,89.9135446685879,6.9164265129683,6.051873198847262,0.8645533141210375,0.8645533141210375,0.2881844380403458,0.57636887608069165,2.3054755043227666
E00156096,455,429,18,13,5,2,1,1,6,94.28571428571428,3.9560439560439558,2.857142857142857,1.098901098901099,0.43956043956043955,0.21978021978021978,0.21978021978021978,1.3186813186813187
E00156097,432,407,9,7,2,8,7,1,8,94.21296296296296,2.083333333333333,1.6203703703703702,0.4629629629629629,1.8518518518518516,1.6203703703703702,0.23148148148148145,1.8518518518518516
E00156098,222,198,15,13,2,3,0,3,6,89.1891891891892,6.756756756756757,5.8558558558558556,0.9009009009009009,1.3513513513513513,0,1.3513513513513513,2.7027027027027026
E00156099,420,392,12,9,3,6,1,5,10,93.33333333333333,2.857142857142857,2.142857142857143,0.7142857142857143,1.4285714285714286,0.2380952380952381,1.1904761904761905,2.380952380952381
E00156100,347,318,11,8,3,7,1,6,11,91.64265129682997,3.170028818443804,2.3054755043227666,0.8645533141210375,2.0172910662824206,0.2881844380403458,1.729106628242075,3.170028818443804
E00156101,306,277,16,9,7,4,2,2,9,90.52287581699346,5.228758169934641,2.941176470588235,2.287581699346405,1.3071895424836601,0.6535947712418301,0.6535947712418301,2.941176470588235
E00156102,257,232,7,3,4,5,2,3,13,90.27237354085604,2.7237354085603114,1.1673151750972763,1.556420233463035,1.9455252918287937,0.7782101167315175,1.1673151750972763,5.058365758754864
E00156103,393,349,16,11,5,11,4,7,17,88.80407124681933,4.071246819338422,2.7989821882951653,1.2722646310432568,2.7989821882951653,1.0178117048346056,1.7811704834605597,4.325699745547073
E00156104,291,256,23,14,9,5,2,3,7,87.97250859106529,7.903780068728522,4.810996563573884,3.0927835051546393,1.718213058419244,0.6872852233676976,1.0309278350515463,2.405498281786942
E00156106,260,237,14,10,4,4,2,2,5,91.15384615384615,5.384615384615385,3.8461538461538463,1.5384615384615385,1.5384615384615385,0.7692307692307693,0.7692307692307693,1.9230769230769231
E00156107,280,246,12,12,0,7,6,1,15,87.85714285714286,4.285714285714286,4.285714285714286,0,2.5,2.142857142857143,0.35714285714285715,5.357142857142857
E00156108,262,251,7,5,2,3,1,2,1,95.80152671755725,2.6717557251908395,1.9083969465648856,0.7633587786259541,1.1450381679389312,0.38167938931297707,0.7633587786259541,0.38167938931297707
E00156110,224,206,11,7,4,5,4,1,2,91.96428571428571,4.910714285714286,3.125,1.7857142857142856,2.232142857142857,1.7857142857142856,0.4464285714285714,0.8928571428571428
E00156111,333,296,27,22,5,7,2,5,3,88.88888888888889,8.108108108108109,6.606606606606606,1.5015015015015014,2.1021021021021022,0.6006006006006006,1.5015015015015014,0.9009009009009009
E00156112,371,338,18,17,1,6,2,4,9,91.10512129380054,4.8517520215633425,4.5822102425876015,0.2695417789757413,1.6172506738544474,0.5390835579514826,1.078167115902965,2.4258760107816713
E00156113,414,372,19,12,7,8,2,6,15,89.85507246376811,4.5893719806763285,2.898550724637681,1.6908212560386473,1.932367149758454,0.4830917874396135,1.4492753623188406,3.6231884057971016
E00156114,296,269,12,8,4,8,0,8,7,90.87837837837837,4.054054054054054,2.7027027027027026,1.3513513513513513,2.7027027027027026,0,2.7027027027027026,2.364864864864865
E00156115,142,134,4,2,2,0,0,0,4,94.36619718309859,2.8169014084507045,1.4084507042253522,1.4084507042253522,0,0,0,2.8169014084507045
E00156116,316,296,10,5,5,3,0,3,7,93.67088607594937,3.1645569620253164,1.5822784810126582,1.5822784810126582,0.949367088607595,0,0.949367088607595,2.2151898734177213
E00156118,284,270,4,4,0,7,3,4,3,95.07042253521126,1.4084507042253522,1.4084507042253522,0,2.464788732394366,1.056338028169014,1.4084507042253522,1.056338028169014
E00156119,318,297,12,10,2,2,1,1,7,93.39622641509435,3.7735849056603774,3.1446540880503147,0.628930817610063,0.628930817610063,0.3144654088050315,0.3144654088050315,2.20125786163522
E00156120,256,244,12,10,2,0,0,0,0,95.3125,4.6875,3.90625,0.78125,0,0,0,0
E00156121,244,235,7,5,2,1,0,1,1,96.31147540983606,2.8688524590163933,2.0491803278688523,0.819672131147541,0.4098360655737705,0,0.4098360655737705,0.4098360655737705
E00156123,262,242,14,12,2,2,1,1,4,92.36641221374046,5.343511450381679,4.580152671755725,0.7633587786259541,0.7633587786259541,0.38167938931297707,0.38167938931297707,1.5267175572519083
E00156124,360,339,8,8,0,4,2,2,9,94.16666666666667,2.2222222222222223,2.2222222222222223,0,1.1111111111111112,0.5555555555555556,0.5555555555555556,2.5
E00156126,366,336,19,15,4,2,0,2,9,91.80327868852459,5.191256830601093,4.098360655737705,1.092896174863388,0.546448087431694,0,0.546448087431694,2.459016393442623
E00156127,313,295,11,7,4,4,2,2,3,94.24920127795528,3.5143769968051117,2.2364217252396164,1.2779552715654952,1.2779552715654952,0.6389776357827476,0.6389776357827476,0.9584664536741214
E00156128,316,284,17,13,4,6,4,2,9,89.87341772151899,5.379746835443038,4.113924050632911,1.2658227848101267,1.89873417721519,1.2658227848101267,0.6329113924050633,2.848101265822785
E00156129,246,220,19,15,4,4,2,2,3,89.43089430894308,7.723577235772358,6.097560975609756,1.6260162601626018,1.6260162601626018,0.8130081300813009,0.8130081300813009,1.2195121951219512
E00156130,286,255,19,15,4,8,4,4,4,89.16083916083916,6.643356643356643,5.244755244755245,1.3986013986013985,2.797202797202797,1.3986013986013985,1.3986013986013985,1.3986013986013985
E00156131,248,238,6,4,2,0,0,0,4,95.96774193548387,2.4193548387096775,1.6129032258064515,0.8064516129032258,0,0,0,1.6129032258064515
E00156132,295,280,10,9,1,4,4,0,1,94.91525423728814,3.389830508474576,3.050847457627119,0.3389830508474576,1.3559322033898304,1.3559322033898304,0,0.3389830508474576
E00156133,196,187,7,7,0,1,1,0,1,95.40816326530613,3.571428571428571,3.571428571428571,0,0.5102040816326531,0.5102040816326531,0,0.5102040816326531
E00156134,312,295,7,4,3,6,2,4,4,94.55128205128204,2.2435897435897436,1.282051282051282,0.9615384615384616,1.9230769230769231,0.641025641025641,1.282051282051282,1.282051282051282
E00156135,357,330,11,9,2,8,6,2,8,92.43697478991596,3.081232492997199,2.5210084033613445,0.5602240896358543,2.2408963585434174,1.680672268907563,0.5602240896358543,2.2408963585434174
E00156136,301,267,18,15,3,5,4,1,11,88.70431893687709,5.980066445182724,4.983388704318937,0.9966777408637874,1.6611295681063125,1.3289036544850499,0.33222591362126247,3.6544850498338874
E00156137,304,267,18,10,8,8,4,4,11,87.82894736842105,5.921052631578947,3.289473684210526,2.631578947368421,2.631578947368421,1.3157894736842104,1.3157894736842104,3.618421052631579
E00156138,330,301,21,16,5,4,2,2,4,91.21212121212122,6.363636363636363,4.848484848484849,1.5151515151515151,1.2121212121212122,0.6060606060606061,0.6060606060606061,1.2121212121212122
E00156139,291,283,5,2,3,1,0,1,2,97.2508591065292,1.718213058419244,0.6872852233676976,1.0309278350515463,0.3436426116838488,0,0.3436426116838488,0.6872852233676976
E00156140,361,340,11,7,4,3,1,2,7,94.18282548476455,3.0470914127423825,1.9390581717451523,1.10803324099723,0.8310249307479225,0.2770083102493075,0.554016620498615,1.9390581717451523
E00156141,360,333,14,12,2,7,5,2,6,92.5,3.888888888888889,3.3333333333333335,0.5555555555555556,1.9444444444444444,1.3888888888888888,0.5555555555555556,1.6666666666666667
E00156142,315,290,16,12,4,6,4,2,3,92.06349206349206,5.079365079365079,3.8095238095238098,1.2698412698412698,1.9047619047619049,1.2698412698412698,0.6349206349206349,0.9523809523809524
E00156143,333,315,4,2,2,10,6,4,4,94.5945945945946,1.2012012012012012,0.6006006006006006,0.6006006006006006,3.003003003003003,1.8018018018018018,1.2012012012012012,1.2012012012012012
E00156144,313,294,7,7,0,3,2,1,9,93.9297124600639,2.2364217252396164,2.2364217252396164,0,0.9584664536741214,0.6389776357827476,0.3194888178913738,2.8753993610223643
E00156145,314,289,7,6,1,7,4,3,11,92.03821656050955,2.229299363057325,1.910828025477707,0.3184713375796179,2.229299363057325,1.2738853503184715,0.9554140127388535,3.5031847133757963
E00156146,248,225,10,8,2,3,1,2,10,90.7258064516129,4.032258064516129,3.225806451612903,0.8064516129032258,1.2096774193548387,0.4032258064516129,0.8064516129032258,4.032258064516129
E00156148,401,378,8,8,0,10,4,6,5,94.2643391521197,1.99501246882793,1.99501246882793,0,2.493765586034913,0.997506234413965,1.4962593516209477,1.2468827930174564
E00156149,305,279,10,7,3,8,3,5,8,91.47540983606557,3.278688524590164,2.2950819672131146,0.9836065573770493,2.622950819672131,0.9836065573770493,1.639344262295082,2.622950819672131
E00156150,337,317,8,6,2,9,4,5,3,94.06528189910979,2.3738872403560833,1.7804154302670623,0.5934718100890208,2.6706231454005933,1.1869436201780417,1.483679525222552,0.8902077151335311
E00156151,242,221,10,7,3,4,2,2,7,91.32231404958677,4.132231404958678,2.8925619834710745,1.2396694214876034,1.6528925619834711,0.8264462809917356,0.8264462809917356,2.8925619834710745
E00156152,362,341,9,7,2,5,1,4,7,94.1988950276243,2.4861878453038675,1.9337016574585635,0.5524861878453038,1.3812154696132597,0.2762430939226519,1.1049723756906076,1.9337016574585635
E00156153,275,249,17,11,6,5,4,1,4,90.54545454545455,6.181818181818182,4,2.181818181818182,1.8181818181818181,1.4545454545454546,0.36363636363636365,1.4545454545454546
E00156154,247,226,10,8,2,3,1,2,8,91.49797570850203,4.048582995951417,3.2388663967611335,0.8097165991902834,1.214574898785425,0.4048582995951417,0.8097165991902834,3.2388663967611335
E00156155,469,421,17,14,3,13,3,10,18,89.76545842217483,3.624733475479744,2.9850746268656714,0.6396588486140725,2.771855010660981,0.6396588486140725,2.1321961620469083,3.8379530916844353
E00156156,366,339,13,8,5,5,1,4,9,92.62295081967213,3.551912568306011,2.185792349726776,1.366120218579235,1.366120218579235,0.273224043715847,1.092896174863388,2.459016393442623
E00156157,260,240,7,4,3,6,2,4,7,92.3076923076923,2.6923076923076925,1.5384615384615385,1.153846153846154,2.307692307692308,0.7692307692307693,1.5384615384615385,2.6923076923076925
E00156158,379,348,23,18,5,0,0,0,8,91.82058047493403,6.068601583113456,4.749340369393139,1.3192612137203166,0,0,0,2.1108179419525066
E00156159,349,324,12,11,1,5,5,0,8,92.83667621776505,3.4383954154727796,3.151862464183381,0.28653295128939826,1.4326647564469914,1.4326647564469914,0,2.292263610315186
E00156160,216,199,11,10,1,4,1,3,2,92.12962962962963,5.092592592592593,4.62962962962963,0.4629629629629629,1.8518518518518516,0.4629629629629629,1.3888888888888888,0.9259259259259258
E00156161,286,266,16,12,4,1,0,1,3,93.00699300699301,5.594405594405594,4.195804195804196,1.3986013986013985,0.34965034965034963,0,0.34965034965034963,1.048951048951049
E00156162,452,415,21,16,5,10,3,7,6,91.8141592920354,4.646017699115045,3.5398230088495577,1.1061946902654867,2.2123893805309733,0.6637168141592921,1.5486725663716814,1.3274336283185841
E00156163,281,263,12,9,3,3,3,0,3,93.59430604982207,4.270462633451958,3.202846975088968,1.0676156583629894,1.0676156583629894,1.0676156583629894,0,1.0676156583629894
E00156164,395,371,18,17,1,0,0,0,6,93.92405063291139,4.556962025316456,4.30379746835443,0.25316455696202533,0,0,0,1.5189873417721518
E00156165,327,305,18,17,1,2,0,2,2,93.27217125382263,5.5045871559633035,5.198776758409786,0.3058103975535168,0.6116207951070336,0,0.6116207951070336,0.6116207951070336
E00156166,284,270,10,8,2,2,0,2,2,95.07042253521126,3.5211267605633805,2.8169014084507045,0.7042253521126761,0.7042253521126761,0,0.7042253521126761,0.7042253521126761
E00156167,324,302,11,11,0,3,1,2,8,93.20987654320987,3.3950617283950617,3.3950617283950617,0,0.9259259259259258,0.30864197530864196,0.6172839506172839,2.4691358024691357
E00156168,277,264,4,4,0,4,1,3,5,95.30685920577618,1.444043321299639,1.444043321299639,0,1.444043321299639,0.36101083032490977,1.083032490974729,1.8050541516245486
E00156169,291,278,9,7,2,1,0,1,3,95.53264604810997,3.0927835051546393,2.405498281786942,0.6872852233676976,0.3436426116838488,0,0.3436426116838488,1.0309278350515463
E00156170,306,287,16,12,4,1,0,1,2,93.79084967320262,5.228758169934641,3.9215686274509802,1.3071895424836601,0.32679738562091504,0,0.32679738562091504,0.6535947712418301
E00156171,289,269,13,12,1,1,0,1,6,93.07958477508652,4.498269896193772,4.1522491349480966,0.34602076124567477,0.34602076124567477,0,0.34602076124567477,2.0761245674740483
E00156172,248,233,7,7,0,5,4,1,3,93.95161290322581,2.82258064516129,2.82258064516129,0,2.0161290322580645,1.6129032258064515,0.4032258064516129,1.2096774193548387
E00156173,289,270,12,10,2,3,2,1,4,93.42560553633218,4.1522491349480966,3.4602076124567476,0.6920415224913495,1.0380622837370241,0.6920415224913495,0.34602076124567477,1.384083044982699
E00156174,284,261,16,10,6,3,1,2,4,91.90140845070422,5.633802816901409,3.5211267605633805,2.112676056338028,1.056338028169014,0.35211267605633806,0.7042253521126761,1.4084507042253522
E00156175,366,339,18,16,2,7,4,3,2,92.62295081967213,4.918032786885246,4.371584699453552,0.546448087431694,1.912568306010929,1.092896174863388,0.819672131147541,0.546448087431694
E00156176,282,267,11,7,4,3,0,3,1,94.68085106382979,3.900709219858156,2.4822695035460995,1.4184397163120568,1.0638297872340425,0,1.0638297872340425,0.3546099290780142
E00156177,339,319,13,10,3,3,0,3,4,94.10029498525073,3.8348082595870205,2.949852507374631,0.8849557522123894,0.8849557522123894,0,0.8849557522123894,1.1799410029498525
E00156178,190,177,8,7,1,4,3,1,1,93.15789473684211,4.2105263157894735,3.684210526315789,0.5263157894736842,2.1052631578947367,1.5789473684210527,0.5263157894736842,0.5263157894736842
E00156179,286,263,6,4,2,8,4,4,9,91.95804195804196,2.097902097902098,1.3986013986013985,0.6993006993006993,2.797202797202797,1.3986013986013985,1.3986013986013985,3.146853146853147
E00156180,334,322,9,8,1,0,0,0,3,96.40718562874252,2.694610778443114,2.3952095808383236,0.29940119760479045,0,0,0,0.8982035928143712
E00156181,402,382,18,17,1,2,1,1,0,95.02487562189054,4.477611940298507,4.228855721393035,0.24875621890547264,0.4975124378109453,0.24875621890547264,0.24875621890547264,0
E00156182,350,333,13,10,3,0,0,0,4,95.14285714285714,3.7142857142857144,2.857142857142857,0.8571428571428572,0,0,0,1.1428571428571428
E00156184,135,127,7,7,0,0,0,0,1,94.07407407407408,5.185185185185185,5.185185185185185,0,0,0,0,0.7407407407407408
E00156185,338,318,13,8,5,4,1,3,3,94.0828402366864,3.8461538461538463,2.366863905325444,1.4792899408284024,1.183431952662722,0.2958579881656805,0.8875739644970414,0.8875739644970414
E00156186,263,255,4,3,1,0,0,0,4,96.95817490494296,1.520912547528517,1.1406844106463878,0.38022813688212925,0,0,0,1.520912547528517
E00156187,264,241,16,12,4,2,1,1,5,91.28787878787878,6.0606060606060606,4.545454545454546,1.5151515151515151,0.7575757575757576,0.3787878787878788,0.3787878787878788,1.893939393939394
E00156188,373,347,22,15,7,2,2,0,2,93.02949061662198,5.898123324396782,4.021447721179625,1.876675603217158,0.5361930294906166,0.5361930294906166,0,0.5361930294906166
E00156189,294,274,8,6,2,5,3,2,7,93.19727891156462,2.7210884353741496,2.0408163265306123,0.6802721088435374,1.7006802721088436,1.0204081632653061,0.6802721088435374,2.380952380952381
E00156190,398,370,18,13,5,5,2,3,5,92.96482412060301,4.522613065326634,3.2663316582914574,1.256281407035176,1.256281407035176,0.5025125628140703,0.7537688442211055,1.256281407035176
E00156191,330,288,27,17,10,6,4,2,9,87.27272727272727,8.181818181818182,5.151515151515151,3.0303030303030303,1.8181818181818181,1.2121212121212122,0.6060606060606061,2.727272727272727
E00156192,283,254,21,16,5,6,2,4,2,89.75265017667844,7.420494699646643,5.6537102473498235,1.76678445229682,2.1201413427561837,0.7067137809187279,1.4134275618374559,0.7067137809187279
E00156193,311,297,10,7,3,0,0,0,4,95.4983922829582,3.215434083601286,2.2508038585209005,0.964630225080386,0,0,0,1.2861736334405145
E00156194,269,250,15,13,2,3,1,2,1,92.93680297397769,5.5762081784386615,4.83271375464684,0.7434944237918215,1.1152416356877324,0.37174721189591076,0.7434944237918215,0.37174721189591076
E00156195,240,222,10,10,0,3,0,3,5,92.5,4.166666666666666,4.166666666666666,0,1.25,0,1.25,2.083333333333333
E00156196,435,408,18,14,4,3,2,1,6,93.79310344827586,4.137931034482759,3.218390804597701,0.9195402298850575,0.6896551724137931,0.45977011494252873,0.22988505747126436,1.3793103448275863
E00156197,417,402,9,7,2,3,0,3,3,96.40287769784173,2.158273381294964,1.6786570743405276,0.4796163069544364,0.7194244604316548,0,0.7194244604316548,0.7194244604316548
E00156198,286,267,10,9,1,2,1,1,7,93.35664335664336,3.4965034965034967,3.146853146853147,0.34965034965034963,0.6993006993006993,0.34965034965034963,0.34965034965034963,2.4475524475524475
E00156199,339,316,21,17,4,2,2,0,0,93.21533923303835,6.1946902654867255,5.014749262536873,1.1799410029498525,0.5899705014749262,0.5899705014749262,0,0
E00156201,417,377,23,14,9,7,4,3,10,90.40767386091127,5.515587529976019,3.357314148681055,2.158273381294964,1.6786570743405276,0.9592326139088728,0.7194244604316548,2.3980815347721824
E00156202,327,301,16,14,2,4,3,1,6,92.04892966360856,4.892966360856269,4.281345565749235,0.6116207951070336,1.2232415902140672,0.9174311926605505,0.3058103975535168,1.834862385321101
E00156203,211,191,12,7,5,4,1,3,4,90.52132701421802,5.687203791469194,3.3175355450236967,2.3696682464454977,1.8957345971563981,0.47393364928909953,1.4218009478672986,1.8957345971563981
E00156204,366,324,30,20,10,3,3,0,9,88.52459016393442,8.19672131147541,5.46448087431694,2.73224043715847,0.819672131147541,0.819672131147541,0,2.459016393442623
E00156205,386,345,26,19,7,12,3,9,3,89.37823834196891,6.7357512953367875,4.922279792746114,1.8134715025906734,3.1088082901554404,0.7772020725388601,2.33160621761658,0.7772020725388601
E00156206,330,311,12,9,3,1,0,1,6,94.24242424242424,3.6363636363636362,2.727272727272727,0.9090909090909091,0.30303030303030304,0,0.30303030303030304,1.8181818181818181
E00156207,385,358,10,8,2,7,3,4,10,92.98701298701299,2.5974025974025974,2.0779220779220777,0.5194805194805194,1.8181818181818181,0.7792207792207793,1.0389610389610389,2.5974025974025974
E00156208,382,353,12,10,2,6,3,3,11,92.40837696335078,3.1413612565445024,2.6178010471204187,0.5235602094240838,1.5706806282722512,0.7853403141361256,0.7853403141361256,2.8795811518324608
E00156209,395,362,10,5,5,12,6,6,11,91.64556962025317,2.5316455696202533,1.2658227848101267,1.2658227848101267,3.0379746835443036,1.5189873417721518,1.5189873417721518,2.7848101265822782
E00156210,230,210,9,5,4,6,4,2,5,91.30434782608695,3.91304347826087,2.1739130434782608,1.7391304347826086,2.608695652173913,1.7391304347826086,0.8695652173913043,2.1739130434782608
E00156211,224,212,5,5,0,2,2,0,5,94.64285714285714,2.232142857142857,2.232142857142857,0,0.8928571428571428,0.8928571428571428,0,2.232142857142857
E00156212,353,314,24,17,7,8,6,2,7,88.95184135977338,6.79886685552408,4.815864022662889,1.9830028328611897,2.26628895184136,1.69971671388102,0.56657223796034,1.9830028328611897
E00156213,293,274,12,10,2,3,1,2,4,93.51535836177474,4.09556313993174,3.4129692832764507,0.6825938566552902,1.023890784982935,0.3412969283276451,0.6825938566552902,1.3651877133105803
E00156214,239,220,11,11,0,3,3,0,5,92.05020920502092,4.602510460251046,4.602510460251046,0,1.2552301255230125,1.2552301255230125,0,2.092050209205021
E00156215,293,267,22,19,3,1,0,1,3,91.12627986348123,7.508532423208192,6.484641638225256,1.023890784982935,0.3412969283276451,0,0.3412969283276451,1.023890784982935
E00156216,354,329,11,3,8,7,4,3,7,92.93785310734464,3.1073446327683616,0.847457627118644,2.2598870056497176,1.977401129943503,1.1299435028248588,0.847457627118644,1.977401129943503
E00156217,257,234,14,12,2,8,4,4,1,91.05058365758755,5.447470817120623,4.669260700389105,0.7782101167315175,3.11284046692607,1.556420233463035,1.556420233463035,0.38910505836575876
E00156218,308,281,12,8,4,8,5,3,7,91.23376623376623,3.896103896103896,2.5974025974025974,1.2987012987012987,2.5974025974025974,1.6233766233766231,0.974025974025974,2.272727272727273
E00156219,236,215,11,7,4,4,3,1,6,91.10169491525424,4.661016949152542,2.9661016949152543,1.694915254237288,1.694915254237288,1.2711864406779663,0.423728813559322,2.5423728813559325
E00156220,209,191,12,10,2,0,0,0,6,91.38755980861244,5.741626794258373,4.784688995215311,0.9569377990430622,0,0,0,2.8708133971291865
E00156221,353,307,19,11,8,10,5,5,17,86.96883852691218,5.382436260623229,3.1161473087818696,2.26628895184136,2.8328611898017,1.41643059490085,1.41643059490085,4.815864022662889
E00156222,280,248,13,11,2,6,5,1,13,88.57142857142857,4.642857142857143,3.9285714285714284,0.7142857142857143,2.142857142857143,1.7857142857142856,0.35714285714285715,4.642857142857143
E00156223,303,283,14,13,1,4,3,1,2,93.3993399339934,4.62046204620462,4.29042904290429,0.33003300330033003,1.3201320132013201,0.9900990099009901,0.33003300330033003,0.6600660066006601
E00156224,136,128,5,4,1,0,0,0,3,94.11764705882352,3.6764705882352944,2.941176470588235,0.7352941176470588,0,0,0,2.2058823529411766
E00156225,250,232,3,1,2,4,1,3,11,92.80000000000001,1.2,0.4,0.8,1.6,0.4,1.2,4.3999999999999995
E00156226,270,242,14,5,9,2,1,1,12,89.62962962962962,5.185185185185185,1.8518518518518516,3.3333333333333335,0.7407407407407408,0.3703703703703704,0.3703703703703704,4.444444444444445
E00156227,296,278,7,7,0,3,1,2,8,93.91891891891892,2.364864864864865,2.364864864864865,0,1.0135135135135136,0.33783783783783783,0.6756756756756757,2.7027027027027026
E00156228,292,261,15,12,3,4,4,0,12,89.38356164383562,5.136986301369863,4.10958904109589,1.0273972602739725,1.36986301369863,1.36986301369863,0,4.10958904109589
E00156229,294,255,11,2,9,6,2,4,22,86.73469387755102,3.741496598639456,0.6802721088435374,3.061224489795918,2.0408163265306123,0.6802721088435374,1.3605442176870748,7.482993197278912
E00156230,324,296,10,7,3,6,4,2,12,91.35802469135803,3.0864197530864197,2.1604938271604937,0.9259259259259258,1.8518518518518516,1.2345679012345678,0.6172839506172839,3.7037037037037033
E00156231,337,299,26,18,8,6,4,2,6,88.72403560830861,7.71513353115727,5.341246290801187,2.3738872403560833,1.7804154302670623,1.1869436201780417,0.5934718100890208,1.7804154302670623
E00156232,307,272,17,12,5,7,5,2,11,88.59934853420195,5.537459283387622,3.908794788273615,1.6286644951140066,2.2801302931596092,1.6286644951140066,0.6514657980456027,3.5830618892508146
E00156233,310,284,21,15,6,0,0,0,5,91.61290322580645,6.774193548387098,4.838709677419355,1.935483870967742,0,0,0,1.6129032258064515
E00156234,302,276,19,14,5,1,0,1,6,91.3907284768212,6.291390728476822,4.635761589403973,1.6556291390728477,0.33112582781456956,0,0.33112582781456956,1.9867549668874174
E00156235,283,260,16,13,3,6,2,4,1,91.87279151943463,5.6537102473498235,4.593639575971731,1.0600706713780919,2.1201413427561837,0.7067137809187279,1.4134275618374559,0.35335689045936397
E00156236,294,268,15,13,2,2,2,0,9,91.15646258503402,5.1020408163265305,4.421768707482993,0.6802721088435374,0.6802721088435374,0.6802721088435374,0,3.061224489795918
E00156237,287,260,19,14,5,3,1,2,5,90.59233449477352,6.620209059233449,4.878048780487805,1.7421602787456445,1.0452961672473868,0.34843205574912894,0.6968641114982579,1.7421602787456445
E00156238,242,225,12,11,1,2,2,0,3,92.97520661157024,4.958677685950414,4.545454545454546,0.4132231404958678,0.8264462809917356,0.8264462809917356,0,1.2396694214876034
E00156239,242,229,11,7,4,0,0,0,2,94.62809917355372,4.545454545454546,2.8925619834710745,1.6528925619834711,0,0,0,0.8264462809917356
E00156240,254,214,19,15,4,3,0,3,18,84.25196850393701,7.480314960629922,5.905511811023622,1.574803149606299,1.1811023622047243,0,1.1811023622047243,7.086614173228346
E00156241,294,269,15,11,4,5,2,3,5,91.49659863945578,5.1020408163265305,3.741496598639456,1.3605442176870748,1.7006802721088436,0.6802721088435374,1.0204081632653061,1.7006802721088436
E00156242,213,203,9,8,1,0,0,0,1,95.30516431924883,4.225352112676056,3.755868544600939,0.4694835680751174,0,0,0,0.4694835680751174
E00156243,278,263,12,9,3,0,0,0,3,94.60431654676259,4.316546762589928,3.237410071942446,1.079136690647482,0,0,0,1.079136690647482
E00156244,373,345,19,12,7,6,3,3,3,92.49329758713137,5.093833780160858,3.2171581769436997,1.876675603217158,1.6085790884718498,0.8042895442359249,0.8042895442359249,0.8042895442359249
E00156245,230,212,8,7,1,4,3,1,6,92.17391304347827,3.4782608695652173,3.0434782608695654,0.43478260869565216,1.7391304347826086,1.3043478260869565,0.43478260869565216,2.608695652173913
E00156246,229,215,8,6,2,1,1,0,5,93.88646288209607,3.4934497816593884,2.6200873362445414,0.8733624454148471,0.43668122270742354,0.43668122270742354,0,2.1834061135371177
E00156247,421,378,26,22,4,5,1,4,12,89.78622327790974,6.175771971496437,5.225653206650831,0.9501187648456058,1.187648456057007,0.23752969121140144,0.9501187648456058,2.8503562945368173
E00156248,236,216,14,12,2,3,3,0,3,91.52542372881356,5.932203389830509,5.084745762711865,0.847457627118644,1.2711864406779663,1.2711864406779663,0,1.2711864406779663
E00156249,319,288,18,16,2,5,2,3,8,90.28213166144201,5.6426332288401255,5.015673981191222,0.6269592476489028,1.5673981191222568,0.6269592476489028,0.9404388714733543,2.507836990595611
E00156250,259,210,29,24,5,8,3,5,12,81.08108108108108,11.196911196911197,9.266409266409266,1.9305019305019304,3.088803088803089,1.1583011583011582,1.9305019305019304,4.633204633204633
E00156251,324,306,14,11,3,1,1,0,3,94.44444444444444,4.320987654320987,3.3950617283950617,0.9259259259259258,0.30864197530864196,0.30864197530864196,0,0.9259259259259258
E00156252,302,281,15,13,2,3,3,0,3,93.04635761589404,4.966887417218543,4.304635761589404,0.6622516556291391,0.9933774834437087,0.9933774834437087,0,0.9933774834437087
E00156253,296,270,17,14,3,2,2,0,7,91.21621621621621,5.743243243243244,4.72972972972973,1.0135135135135136,0.6756756756756757,0.6756756756756757,0,2.364864864864865
E00156254,264,247,10,10,0,2,2,0,5,93.56060606060606,3.787878787878788,3.787878787878788,0,0.7575757575757576,0.7575757575757576,0,1.893939393939394
E00156255,255,227,17,13,4,6,6,0,5,89.01960784313725,6.666666666666667,5.098039215686274,1.5686274509803921,2.3529411764705883,2.3529411764705883,0,1.9607843137254901
E00156256,284,264,14,13,1,0,0,0,6,92.95774647887323,4.929577464788732,4.577464788732395,0.35211267605633806,0,0,0,2.112676056338028
E00156257,301,265,16,15,1,7,2,5,13,88.03986710963456,5.3156146179401995,4.983388704318937,0.33222591362126247,2.3255813953488373,0.6644518272425249,1.6611295681063125,4.318936877076411
E00156258,249,219,18,14,4,8,5,3,4,87.95180722891565,7.228915662650602,5.622489959839357,1.6064257028112447,3.2128514056224895,2.0080321285140563,1.2048192771084338,1.6064257028112447
E00156259,228,204,13,9,4,7,2,5,4,89.47368421052632,5.701754385964912,3.9473684210526314,1.7543859649122806,3.070175438596491,0.8771929824561403,2.1929824561403506,1.7543859649122806
E00156260,340,313,14,11,3,5,2,3,8,92.05882352941175,4.117647058823529,3.2352941176470593,0.8823529411764706,1.4705882352941175,0.5882352941176471,0.8823529411764706,2.3529411764705883
E00156261,411,372,14,12,2,5,2,3,20,90.51094890510949,3.40632603406326,2.9197080291970803,0.48661800486618007,1.2165450121654502,0.48661800486618007,0.7299270072992701,4.866180048661801
E00156262,280,260,12,9,3,3,0,3,5,92.85714285714286,4.285714285714286,3.214285714285714,1.0714285714285714,1.0714285714285714,0,1.0714285714285714,1.7857142857142856
E00156263,288,257,15,11,4,7,3,4,9,89.23611111111111,5.208333333333334,3.8194444444444446,1.3888888888888888,2.430555555555556,1.0416666666666665,1.3888888888888888,3.125
E00156264,288,259,22,15,7,1,0,1,6,89.93055555555556,7.638888888888889,5.208333333333334,2.430555555555556,0.3472222222222222,0,0.3472222222222222,2.083333333333333
E00156265,316,275,25,18,7,4,3,1,12,87.0253164556962,7.9113924050632916,5.69620253164557,2.2151898734177213,1.2658227848101267,0.949367088607595,0.31645569620253167,3.79746835443038
E00156266,363,335,16,14,2,4,2,2,8,92.28650137741047,4.40771349862259,3.8567493112947657,0.5509641873278237,1.1019283746556474,0.5509641873278237,0.5509641873278237,2.203856749311295
E00156267,259,238,15,12,3,5,1,4,1,91.8918918918919,5.7915057915057915,4.633204633204633,1.1583011583011582,1.9305019305019304,0.3861003861003861,1.5444015444015444,0.3861003861003861
E00156268,317,279,21,14,7,10,5,5,7,88.01261829652996,6.624605678233439,4.416403785488959,2.2082018927444795,3.1545741324921135,1.5772870662460567,1.5772870662460567,2.2082018927444795
E00156269,284,261,11,8,3,5,3,2,7,91.90140845070422,3.873239436619718,2.8169014084507045,1.056338028169014,1.7605633802816902,1.056338028169014,0.7042253521126761,2.464788732394366
E00156270,293,274,13,12,1,3,2,1,3,93.51535836177474,4.436860068259386,4.09556313993174,0.3412969283276451,1.023890784982935,0.6825938566552902,0.3412969283276451,1.023890784982935
E00156271,219,195,9,7,2,8,3,5,7,89.04109589041096,4.10958904109589,3.1963470319634704,0.91324200913242,3.65296803652968,1.36986301369863,2.28310502283105,3.1963470319634704
E00156272,252,232,7,5,2,6,3,3,7,92.06349206349206,2.7777777777777777,1.984126984126984,0.7936507936507936,2.380952380952381,1.1904761904761905,1.1904761904761905,2.7777777777777777
E00156273,212,187,18,13,5,1,0,1,6,88.20754716981132,8.49056603773585,6.132075471698113,2.358490566037736,0.4716981132075472,0,0.4716981132075472,2.8301886792452833
E00156274,216,196,11,10,1,1,1,0,8,90.74074074074075,5.092592592592593,4.62962962962963,0.4629629629629629,0.4629629629629629,0.4629629629629629,0,3.7037037037037033
E00156275,211,200,6,5,1,2,2,0,3,94.7867298578199,2.843601895734597,2.3696682464454977,0.47393364928909953,0.9478672985781991,0.9478672985781991,0,1.4218009478672986
E00156276,269,247,11,9,2,4,1,3,7,91.82156133828995,4.089219330855019,3.3457249070631967,0.7434944237918215,1.486988847583643,0.37174721189591076,1.1152416356877324,2.6022304832713754
E00156277,341,310,15,9,6,6,5,1,10,90.9090909090909,4.398826979472141,2.6392961876832843,1.7595307917888565,1.7595307917888565,1.466275659824047,0.2932551319648094,2.932551319648094
E00156278,305,277,19,17,2,4,4,0,5,90.81967213114754,6.229508196721312,5.573770491803279,0.6557377049180327,1.3114754098360655,1.3114754098360655,0,1.639344262295082
E00156279,333,319,7,5,2,5,3,2,2,95.7957957957958,2.1021021021021022,1.5015015015015014,0.6006006006006006,1.5015015015015014,0.9009009009009009,0.6006006006006006,0.6006006006006006
E00156280,270,256,6,5,1,3,0,3,5,94.81481481481482,2.2222222222222223,1.8518518518518516,0.3703703703703704,1.1111111111111112,0,1.1111111111111112,1.8518518518518516
E00156281,302,265,18,11,7,3,2,1,16,87.74834437086093,5.960264900662252,3.642384105960265,2.3178807947019866,0.9933774834437087,0.6622516556291391,0.33112582781456956,5.298013245033113
E00156282,281,258,13,9,4,3,1,2,7,91.81494661921708,4.6263345195729535,3.202846975088968,1.4234875444839856,1.0676156583629894,0.3558718861209964,0.7117437722419928,2.491103202846975
E00170383,233,220,4,3,1,3,2,1,6,94.4206008583691,1.7167381974248928,1.2875536480686696,0.4291845493562232,1.2875536480686696,0.8583690987124464,0.4291845493562232,2.575107296137339
E00170384,260,242,9,8,1,4,2,2,5,93.07692307692308,3.4615384615384617,3.076923076923077,0.38461538461538464,1.5384615384615385,0.7692307692307693,0.7692307692307693,1.9230769230769231
E00170385,207,197,6,5,1,0,0,0,4,95.16908212560386,2.898550724637681,2.4154589371980677,0.4830917874396135,0,0,0,1.932367149758454
E00170386,191,187,3,2,1,0,0,0,1,97.90575916230367,1.5706806282722512,1.0471204188481675,0.5235602094240838,0,0,0,0.5235602094240838
E00170387,341,315,10,8,2,3,1,2,13,92.37536656891496,2.932551319648094,2.346041055718475,0.5865102639296188,0.8797653958944283,0.2932551319648094,0.5865102639296188,3.812316715542522
E00170388,428,405,13,8,5,4,4,0,6,94.62616822429906,3.0373831775700935,1.8691588785046727,1.1682242990654206,0.9345794392523363,0.9345794392523363,0,1.4018691588785046
E00170389,233,222,4,3,1,5,3,2,2,95.27896995708154,1.7167381974248928,1.2875536480686696,0.4291845493562232,2.1459227467811157,1.2875536480686696,0.8583690987124464,0.8583690987124464
E00170390,226,218,4,4,0,2,0,2,2,96.46017699115043,1.7699115044247788,1.7699115044247788,0,0.8849557522123894,0,0.8849557522123894,0.8849557522123894
E00170391,254,243,4,2,2,5,2,3,2,95.66929133858267,1.574803149606299,0.7874015748031495,0.7874015748031495,1.968503937007874,0.7874015748031495,1.1811023622047243,0.7874015748031495
E00170392,226,213,8,6,2,4,1,3,1,94.24778761061947,3.5398230088495577,2.6548672566371683,0.8849557522123894,1.7699115044247788,0.4424778761061947,1.3274336283185841,0.4424778761061947
E00170393,304,277,21,14,7,3,2,1,3,91.11842105263158,6.907894736842106,4.605263157894736,2.302631578947368,0.9868421052631579,0.6578947368421052,0.3289473684210526,0.9868421052631579
E00170394,277,255,10,7,3,1,1,0,11,92.05776173285199,3.6101083032490973,2.527075812274368,1.083032490974729,0.36101083032490977,0.36101083032490977,0,3.9711191335740073
E00170396,251,236,8,5,3,5,2,3,2,94.02390438247012,3.187250996015936,1.9920318725099602,1.1952191235059761,1.9920318725099602,0.796812749003984,1.1952191235059761,0.796812749003984
E00170397,256,233,12,12,0,3,2,1,8,91.015625,4.6875,4.6875,0,1.171875,0.78125,0.390625,3.125
E00170398,216,197,10,7,3,7,3,4,2,91.20370370370371,4.62962962962963,3.2407407407407405,1.3888888888888888,3.2407407407407405,1.3888888888888888,1.8518518518518516,0.9259259259259258
E00170399,295,279,9,6,3,1,0,1,6,94.57627118644068,3.050847457627119,2.0338983050847457,1.0169491525423728,0.3389830508474576,0,0.3389830508474576,2.0338983050847457
E00170400,252,226,16,12,4,7,4,3,3,89.68253968253968,6.349206349206349,4.761904761904762,1.5873015873015872,2.7777777777777777,1.5873015873015872,1.1904761904761905,1.1904761904761905
E00170402,343,325,14,14,0,2,2,0,2,94.75218658892129,4.081632653061225,4.081632653061225,0,0.5830903790087464,0.5830903790087464,0,0.5830903790087464
E00170403,1370,1284,47,37,10,23,18,5,16,93.72262773722628,3.43065693430657,2.7007299270072993,0.7299270072992701,1.6788321167883213,1.313868613138686,0.36496350364963503,1.167883211678832
E00170404,339,311,23,16,7,2,1,1,3,91.74041297935102,6.784660766961652,4.71976401179941,2.0648967551622417,0.5899705014749262,0.2949852507374631,0.2949852507374631,0.8849557522123894
E00170405,457,434,14,10,4,5,3,2,4,94.9671772428884,3.063457330415755,2.1881838074398248,0.87527352297593,1.0940919037199124,0.6564551422319475,0.437636761487965,0.87527352297593
E00170406,263,243,19,18,1,1,0,1,0,92.39543726235742,7.224334600760455,6.844106463878327,0.38022813688212925,0.38022813688212925,0,0.38022813688212925,0
E00170407,341,308,19,18,1,3,1,2,11,90.32258064516128,5.571847507331378,5.278592375366569,0.2932551319648094,0.8797653958944283,0.2932551319648094,0.5865102639296188,3.225806451612903
E00170408,285,270,6,6,0,3,1,2,6,94.73684210526315,2.1052631578947367,2.1052631578947367,0,1.0526315789473684,0.3508771929824561,0.7017543859649122,2.1052631578947367
E00170409,355,332,16,8,8,5,3,2,2,93.52112676056338,4.507042253521127,2.2535211267605635,2.2535211267605635,1.4084507042253522,0.8450704225352111,0.5633802816901409,0.5633802816901409
E00170410,215,195,12,11,1,5,2,3,3,90.69767441860465,5.5813953488372094,5.116279069767442,0.46511627906976744,2.3255813953488373,0.9302325581395349,1.3953488372093024,1.3953488372093024
E00170411,287,271,11,9,2,2,1,1,3,94.42508710801394,3.8327526132404177,3.1358885017421603,0.6968641114982579,0.6968641114982579,0.34843205574912894,0.34843205574912894,1.0452961672473868
E00190475,267,260,5,3,2,2,1,1,0,97.37827715355806,1.8726591760299627,1.1235955056179776,0.7490636704119851,0.7490636704119851,0.37453183520599254,0.37453183520599254,0
E00190476,279,267,7,6,1,4,0,4,1,95.6989247311828,2.5089605734767026,2.1505376344086025,0.35842293906810035,1.4336917562724014,0,1.4336917562724014,0.35842293906810035
E00190477,277,249,15,14,1,3,3,0,10,89.89169675090253,5.415162454873646,5.054151624548736,0.36101083032490977,1.083032490974729,1.083032490974729,0,3.6101083032490973
E00190478,290,269,10,10,0,3,3,0,8,92.75862068965517,3.4482758620689653,3.4482758620689653,0,1.0344827586206897,1.0344827586206897,0,2.7586206896551726
E00190480,351,322,19,14,5,5,2,3,5,91.73789173789174,5.413105413105413,3.9886039886039883,1.4245014245014245,1.4245014245014245,0.5698005698005698,0.8547008547008548,1.4245014245014245
E00190483,261,254,5,4,1,2,2,0,0,97.31800766283524,1.9157088122605364,1.532567049808429,0.38314176245210724,0.7662835249042145,0.7662835249042145,0,0
E00190484,273,261,3,3,0,4,3,1,5,95.6043956043956,1.098901098901099,1.098901098901099,0,1.465201465201465,1.098901098901099,0.3663003663003663,1.8315018315018317
E00190487,261,246,7,6,1,3,0,3,5,94.25287356321839,2.681992337164751,2.2988505747126435,0.38314176245210724,1.1494252873563218,0,1.1494252873563218,1.9157088122605364
E00190488,350,319,16,11,5,4,3,1,11,91.14285714285715,4.571428571428571,3.1428571428571432,1.4285714285714286,1.1428571428571428,0.8571428571428572,0.2857142857142857,3.1428571428571432
E00190489,291,270,11,8,3,6,1,5,4,92.78350515463917,3.7800687285223367,2.7491408934707904,1.0309278350515463,2.0618556701030926,0.3436426116838488,1.718213058419244,1.3745704467353952
E00190491,396,364,18,15,3,6,2,4,8,91.91919191919192,4.545454545454546,3.787878787878788,0.7575757575757576,1.5151515151515151,0.5050505050505051,1.0101010101010102,2.0202020202020203
E00190492,169,153,2,2,0,3,1,2,11,90.53254437869822,1.183431952662722,1.183431952662722,0,1.7751479289940828,0.591715976331361,1.183431952662722,6.508875739644971
E00190494,282,269,5,4,1,5,2,3,3,95.39007092198581,1.773049645390071,1.4184397163120568,0.3546099290780142,1.773049645390071,0.7092198581560284,1.0638297872340425,1.0638297872340425
E00190496,289,272,5,5,0,9,9,0,3,94.11764705882352,1.7301038062283738,1.7301038062283738,0,3.1141868512110724,3.1141868512110724,0,1.0380622837370241
E00190497,282,274,6,5,1,0,0,0,2,97.16312056737588,2.127659574468085,1.773049645390071,0.3546099290780142,0,0,0,0.7092198581560284
E00190504,248,236,6,5,1,3,1,2,3,95.16129032258065,2.4193548387096775,2.0161290322580645,0.4032258064516129,1.2096774193548387,0.4032258064516129,0.8064516129032258,1.2096774193548387
E00190505,244,233,6,5,1,3,2,1,2,95.49180327868852,2.459016393442623,2.0491803278688523,0.4098360655737705,1.2295081967213115,0.819672131147541,0.4098360655737705,0.819672131147541
E00190507,178,174,3,2,1,1,1,0,0,97.75280898876404,1.6853932584269662,1.1235955056179776,0.5617977528089888,0.5617977528089888,0.5617977528089888,0,0
E00190508,346,327,4,3,1,5,1,4,10,94.50867052023122,1.1560693641618496,0.8670520231213872,0.2890173410404624,1.4450867052023122,0.2890173410404624,1.1560693641618496,2.8901734104046244
E00190510,231,225,3,3,0,0,0,0,3,97.40259740259741,1.2987012987012987,1.2987012987012987,0,0,0,0,1.2987012987012987
E00190511,254,246,7,6,1,1,0,1,0,96.8503937007874,2.7559055118110236,2.3622047244094486,0.39370078740157477,0.39370078740157477,0,0.39370078740157477,0
E00190514,111,98,7,7,0,2,2,0,4,88.28828828828829,6.306306306306306,6.306306306306306,0,1.8018018018018018,1.8018018018018018,0,3.6036036036036037
E00190516,251,241,7,6,1,0,0,0,3,96.01593625498009,2.788844621513944,2.3904382470119523,0.398406374501992,0,0,0,1.1952191235059761
E00190517,579,561,15,13,2,1,1,0,2,96.89119170984456,2.5906735751295336,2.2452504317789295,0.3454231433506045,0.17271157167530224,0.17271157167530224,0,0.3454231433506045
E00190518,302,282,9,5,4,6,3,3,5,93.37748344370861,2.980132450331126,1.6556291390728477,1.3245033112582782,1.9867549668874174,0.9933774834437087,0.9933774834437087,1.6556291390728477
E00190519,290,270,10,9,1,4,2,2,6,93.10344827586206,3.4482758620689653,3.103448275862069,0.3448275862068966,1.3793103448275863,0.6896551724137931,0.6896551724137931,2.0689655172413794
E00190520,301,287,10,7,3,2,0,2,2,95.34883720930233,3.322259136212625,2.3255813953488373,0.9966777408637874,0.6644518272425249,0,0.6644518272425249,0.6644518272425249
E00190522,264,256,4,2,2,4,2,2,0,96.96969696969697,1.5151515151515151,0.7575757575757576,0.7575757575757576,1.5151515151515151,0.7575757575757576,0.7575757575757576,0
E00190523,311,284,14,12,2,4,4,0,9,91.31832797427653,4.501607717041801,3.858520900321544,0.6430868167202572,1.2861736334405145,1.2861736334405145,0,2.8938906752411575
E00190524,366,344,12,7,5,2,1,1,8,93.98907103825137,3.278688524590164,1.912568306010929,1.366120218579235,0.546448087431694,0.273224043715847,0.273224043715847,2.185792349726776
