OA,ts0390001,ts0390002,ts0390003,ts0390004,ts0390005,ts0390006,ts0390007,ts0390008,ts0390009,ts0390002_PCT,ts0390003_PCT,ts0390004_PCT,ts0390005_PCT,ts0390006_PCT,ts0390007_PCT,ts0390008_PCT,ts0390009_PCT
E00022487,373,353,13,9,4,4,2,2,3,94.63806970509383,3.485254691689008,2.4128686327077746,1.0723860589812333,1.0723860589812333,0.5361930294906166,0.5361930294906166,0.8042895442359249
E00022488,430,411,14,10,4,1,1,0,4,95.5813953488372,3.255813953488372,2.3255813953488373,0.9302325581395349,0.23255813953488372,0.23255813953488372,0,0.9302325581395349
E00022489,271,262,6,6,0,1,1,0,2,96.6789667896679,2.214022140221402,2.214022140221402,0,0.36900369003690037,0.36900369003690037,0,0.7380073800738007
E00022490,312,285,10,8,2,4,4,0,13,91.34615384615384,3.205128205128205,2.564102564102564,0.641025641025641,1.282051282051282,1.282051282051282,0,4.166666666666666
E00022491,319,307,6,6,0,3,0,3,3,96.23824451410658,1.8808777429467085,1.8808777429467085,0,0.9404388714733543,0,0.9404388714733543,0.9404388714733543
E00022492,231,207,12,7,5,5,3,2,7,89.6103896103896,5.194805194805195,3.0303030303030303,2.1645021645021645,2.1645021645021645,1.2987012987012987,0.8658008658008658,3.0303030303030303
E00022493,321,307,10,8,2,3,2,1,1,95.6386292834891,3.115264797507788,2.4922118380062304,0.6230529595015576,0.9345794392523363,0.6230529595015576,0.3115264797507788,0.3115264797507788
E00022494,353,329,13,11,2,8,4,4,3,93.20113314447592,3.6827195467422094,3.1161473087818696,0.56657223796034,2.26628895184136,1.13314447592068,1.13314447592068,0.84985835694051
E00022495,338,323,8,4,4,4,3,1,3,95.56213017751479,2.366863905325444,1.183431952662722,1.183431952662722,1.183431952662722,0.8875739644970414,0.2958579881656805,0.8875739644970414
E00022497,405,384,17,13,4,3,1,2,1,94.81481481481482,4.197530864197531,3.2098765432098766,0.9876543209876543,0.7407407407407408,0.24691358024691357,0.49382716049382713,0.24691358024691357
E00022498,339,320,12,8,4,3,1,2,4,94.3952802359882,3.5398230088495577,2.359882005899705,1.1799410029498525,0.8849557522123894,0.2949852507374631,0.5899705014749262,1.1799410029498525
E00022499,364,357,7,1,6,0,0,0,0,98.07692307692307,1.9230769230769231,0.27472527472527475,1.6483516483516485,0,0,0,0
E00022500,338,322,6,4,2,3,0,3,7,95.26627218934911,1.7751479289940828,1.183431952662722,0.591715976331361,0.8875739644970414,0,0.8875739644970414,2.0710059171597637
E00022501,265,254,5,4,1,3,1,2,3,95.84905660377359,1.8867924528301887,1.509433962264151,0.37735849056603776,1.1320754716981132,0.37735849056603776,0.7547169811320755,1.1320754716981132
E00022502,386,374,6,6,0,4,3,1,2,96.89119170984456,1.5544041450777202,1.5544041450777202,0,1.0362694300518136,0.7772020725388601,0.2590673575129534,0.5181347150259068
E00022503,297,271,22,21,1,1,0,1,3,91.24579124579124,7.4074074074074066,7.07070707070707,0.33670033670033667,0.33670033670033667,0,0.33670033670033667,1.0101010101010102
E00022504,278,258,15,8,7,2,0,2,3,92.80575539568345,5.39568345323741,2.877697841726619,2.5179856115107913,0.7194244604316548,0,0.7194244604316548,1.079136690647482
E00022505,289,278,6,5,1,1,0,1,4,96.19377162629758,2.0761245674740483,1.7301038062283738,0.34602076124567477,0.34602076124567477,0,0.34602076124567477,1.384083044982699
E00022506,276,258,11,10,1,4,1,3,3,93.47826086956522,3.985507246376811,3.6231884057971016,0.36231884057971014,1.4492753623188406,0.36231884057971014,1.0869565217391304,1.0869565217391304
E00022507,313,299,8,4,4,2,2,0,4,95.52715654952077,2.5559105431309903,1.2779552715654952,1.2779552715654952,0.6389776357827476,0.6389776357827476,0,1.2779552715654952
E00022508,401,386,8,5,3,4,0,4,3,96.25935162094763,1.99501246882793,1.2468827930174564,0.7481296758104738,0.997506234413965,0,0.997506234413965,0.7481296758104738
E00022509,309,295,9,7,2,2,2,0,3,95.46925566343042,2.912621359223301,2.26537216828479,0.6472491909385114,0.6472491909385114,0.6472491909385114,0,0.9708737864077669
E00022510,404,392,10,8,2,0,0,0,2,97.02970297029702,2.4752475247524752,1.9801980198019802,0.49504950495049505,0,0,0,0.49504950495049505
E00022511,378,365,6,6,0,6,5,1,1,96.56084656084656,1.5873015873015872,1.5873015873015872,0,1.5873015873015872,1.3227513227513228,0.26455026455026454,0.26455026455026454
E00022512,299,287,5,5,0,5,4,1,2,95.9866220735786,1.6722408026755853,1.6722408026755853,0,1.6722408026755853,1.3377926421404682,0.33444816053511706,0.6688963210702341
E00022513,150,137,6,4,2,1,1,0,6,91.33333333333333,4,2.666666666666667,1.3333333333333335,0.6666666666666667,0.6666666666666667,0,4
E00022514,331,314,10,7,3,2,0,2,5,94.86404833836858,3.0211480362537766,2.1148036253776437,0.906344410876133,0.6042296072507553,0,0.6042296072507553,1.5105740181268883
E00022515,207,196,8,6,2,2,2,0,1,94.68599033816425,3.864734299516908,2.898550724637681,0.966183574879227,0.966183574879227,0.966183574879227,0,0.4830917874396135
E00022516,300,287,8,8,0,3,1,2,2,95.66666666666667,2.666666666666667,2.666666666666667,0,1,0.33333333333333337,0.6666666666666667,0.6666666666666667
E00022517,466,452,6,4,2,8,1,7,0,96.99570815450643,1.2875536480686696,0.8583690987124464,0.4291845493562232,1.7167381974248928,0.2145922746781116,1.502145922746781,0
E00022518,267,246,13,12,1,3,2,1,5,92.13483146067416,4.868913857677903,4.49438202247191,0.37453183520599254,1.1235955056179776,0.7490636704119851,0.37453183520599254,1.8726591760299627
E00022519,251,244,1,1,0,5,0,5,1,97.21115537848605,0.398406374501992,0.398406374501992,0,1.9920318725099602,0,1.9920318725099602,0.398406374501992
E00022520,331,291,21,6,15,2,0,2,17,87.91540785498489,6.3444108761329305,1.812688821752266,4.531722054380665,0.6042296072507553,0,0.6042296072507553,5.13595166163142
E00022521,235,218,10,7,3,3,1,2,4,92.76595744680851,4.25531914893617,2.9787234042553195,1.276595744680851,1.276595744680851,0.425531914893617,0.851063829787234,1.702127659574468
E00022522,296,280,7,7,0,5,4,1,4,94.5945945945946,2.364864864864865,2.364864864864865,0,1.6891891891891893,1.3513513513513513,0.33783783783783783,1.3513513513513513
E00022523,338,325,9,9,0,3,2,1,1,96.15384615384616,2.6627218934911245,2.6627218934911245,0,0.8875739644970414,0.591715976331361,0.2958579881656805,0.2958579881656805
E00022524,228,214,11,9,2,1,0,1,2,93.85964912280701,4.824561403508771,3.9473684210526314,0.8771929824561403,0.43859649122807015,0,0.43859649122807015,0.8771929824561403
E00022525,344,332,8,7,1,3,1,2,1,96.51162790697676,2.3255813953488373,2.0348837209302326,0.29069767441860467,0.872093023255814,0.29069767441860467,0.5813953488372093,0.29069767441860467
E00022526,395,368,12,7,5,5,3,2,10,93.16455696202532,3.0379746835443036,1.7721518987341773,1.2658227848101267,1.2658227848101267,0.7594936708860759,0.5063291139240507,2.5316455696202533
E00022527,275,264,9,8,1,1,1,0,1,96,3.272727272727273,2.909090909090909,0.36363636363636365,0.36363636363636365,0.36363636363636365,0,0.36363636363636365
E00022528,316,305,5,3,2,3,1,2,3,96.51898734177216,1.5822784810126582,0.949367088607595,0.6329113924050633,0.949367088607595,0.31645569620253167,0.6329113924050633,0.949367088607595
E00022529,415,396,13,10,3,4,3,1,2,95.42168674698796,3.132530120481928,2.4096385542168677,0.7228915662650602,0.9638554216867471,0.7228915662650602,0.24096385542168677,0.48192771084337355
E00022530,287,265,11,8,3,4,4,0,7,92.33449477351915,3.8327526132404177,2.7874564459930316,1.0452961672473868,1.3937282229965158,1.3937282229965158,0,2.4390243902439024
E00022531,263,254,5,5,0,2,1,1,2,96.57794676806084,1.9011406844106464,1.9011406844106464,0,0.7604562737642585,0.38022813688212925,0.38022813688212925,0.7604562737642585
E00022532,206,196,5,3,2,2,2,0,3,95.14563106796116,2.4271844660194173,1.4563106796116505,0.9708737864077669,0.9708737864077669,0.9708737864077669,0,1.4563106796116505
E00022533,242,229,9,6,3,3,1,2,1,94.62809917355372,3.71900826446281,2.479338842975207,1.2396694214876034,1.2396694214876034,0.4132231404958678,0.8264462809917356,0.4132231404958678
E00022534,222,200,14,13,1,2,0,2,6,90.09009009009009,6.306306306306306,5.8558558558558556,0.45045045045045046,0.9009009009009009,0,0.9009009009009009,2.7027027027027026
E00022535,261,248,9,6,3,1,1,0,3,95.01915708812261,3.4482758620689653,2.2988505747126435,1.1494252873563218,0.38314176245210724,0.38314176245210724,0,1.1494252873563218
E00022536,267,255,10,8,2,1,0,1,1,95.50561797752809,3.7453183520599254,2.9962546816479403,0.7490636704119851,0.37453183520599254,0,0.37453183520599254,0.37453183520599254
E00022537,309,299,9,8,1,1,0,1,0,96.76375404530745,2.912621359223301,2.5889967637540456,0.3236245954692557,0.3236245954692557,0,0.3236245954692557,0
E00022538,269,256,4,4,0,6,2,4,3,95.16728624535315,1.486988847583643,1.486988847583643,0,2.2304832713754648,0.7434944237918215,1.486988847583643,1.1152416356877324
E00022539,300,280,13,8,5,4,1,3,3,93.33333333333333,4.333333333333334,2.666666666666667,1.6666666666666667,1.3333333333333335,0.33333333333333337,1,1
E00022540,248,223,14,10,4,7,3,4,4,89.91935483870968,5.64516129032258,4.032258064516129,1.6129032258064515,2.82258064516129,1.2096774193548387,1.6129032258064515,1.6129032258064515
E00022541,513,500,6,6,0,5,2,3,2,97.46588693957115,1.1695906432748537,1.1695906432748537,0,0.9746588693957114,0.3898635477582846,0.5847953216374269,0.3898635477582846
E00022542,312,291,14,10,4,3,0,3,4,93.26923076923077,4.487179487179487,3.205128205128205,1.282051282051282,0.9615384615384616,0,0.9615384615384616,1.282051282051282
E00022543,332,318,9,6,3,2,2,0,3,95.78313253012048,2.710843373493976,1.8072289156626504,0.9036144578313252,0.6024096385542169,0.6024096385542169,0,0.9036144578313252
E00022544,309,292,10,5,5,1,1,0,6,94.49838187702265,3.2362459546925564,1.6181229773462782,1.6181229773462782,0.3236245954692557,0.3236245954692557,0,1.9417475728155338
E00022545,226,215,6,4,2,3,2,1,2,95.13274336283186,2.6548672566371683,1.7699115044247788,0.8849557522123894,1.3274336283185841,0.8849557522123894,0.4424778761061947,0.8849557522123894
E00022546,323,299,14,11,3,7,4,3,3,92.56965944272446,4.3343653250774,3.4055727554179565,0.9287925696594427,2.1671826625387,1.238390092879257,0.9287925696594427,0.9287925696594427
E00022547,248,233,9,7,2,3,0,3,3,93.95161290322581,3.6290322580645165,2.82258064516129,0.8064516129032258,1.2096774193548387,0,1.2096774193548387,1.2096774193548387
E00022548,222,208,9,9,0,3,2,1,2,93.69369369369369,4.054054054054054,4.054054054054054,0,1.3513513513513513,0.9009009009009009,0.45045045045045046,0.9009009009009009
E00022549,299,290,5,5,0,3,1,2,1,96.98996655518395,1.6722408026755853,1.6722408026755853,0,1.0033444816053512,0.33444816053511706,0.6688963210702341,0.33444816053511706
E00022550,253,239,11,11,0,3,0,3,0,94.46640316205533,4.3478260869565215,4.3478260869565215,0,1.185770750988142,0,1.185770750988142,0
E00022551,144,136,6,5,1,1,0,1,1,94.44444444444444,4.166666666666666,3.4722222222222223,0.6944444444444444,0.6944444444444444,0,0.6944444444444444,0.6944444444444444
E00022552,335,319,12,10,2,1,1,0,3,95.22388059701493,3.582089552238806,2.9850746268656714,0.5970149253731344,0.2985074626865672,0.2985074626865672,0,0.8955223880597015
E00022553,245,234,6,4,2,2,2,0,3,95.51020408163265,2.4489795918367347,1.6326530612244898,0.8163265306122449,0.8163265306122449,0.8163265306122449,0,1.2244897959183674
E00022554,210,196,7,6,1,3,3,0,4,93.33333333333333,3.3333333333333335,2.857142857142857,0.4761904761904762,1.4285714285714286,1.4285714285714286,0,1.9047619047619049
E00022555,207,193,7,5,2,4,1,3,3,93.23671497584542,3.3816425120772946,2.4154589371980677,0.966183574879227,1.932367149758454,0.4830917874396135,1.4492753623188406,1.4492753623188406
E00022556,270,256,6,5,1,6,1,5,2,94.81481481481482,2.2222222222222223,1.8518518518518516,0.3703703703703704,2.2222222222222223,0.3703703703703704,1.8518518518518516,0.7407407407407408
E00022557,179,160,11,10,1,3,2,1,5,89.3854748603352,6.145251396648044,5.58659217877095,0.5586592178770949,1.675977653631285,1.1173184357541899,0.5586592178770949,2.793296089385475
E00022558,261,245,6,4,2,4,2,2,6,93.86973180076629,2.2988505747126435,1.532567049808429,0.7662835249042145,1.532567049808429,0.7662835249042145,0.7662835249042145,2.2988505747126435
E00022559,248,228,10,5,5,6,3,3,4,91.93548387096774,4.032258064516129,2.0161290322580645,2.0161290322580645,2.4193548387096775,1.2096774193548387,1.2096774193548387,1.6129032258064515
E00022560,271,249,16,9,7,1,1,0,5,91.88191881918819,5.904059040590406,3.3210332103321036,2.5830258302583027,0.36900369003690037,0.36900369003690037,0,1.8450184501845017
E00022561,202,182,12,8,4,6,3,3,2,90.0990099009901,5.9405940594059405,3.9603960396039604,1.9801980198019802,2.9702970297029703,1.4851485148514851,1.4851485148514851,0.9900990099009901
E00022562,258,248,7,5,2,2,1,1,1,96.12403100775194,2.7131782945736433,1.937984496124031,0.7751937984496124,0.7751937984496124,0.3875968992248062,0.3875968992248062,0.3875968992248062
E00022563,268,259,5,3,2,1,1,0,3,96.64179104477611,1.8656716417910446,1.1194029850746268,0.7462686567164178,0.3731343283582089,0.3731343283582089,0,1.1194029850746268
E00022564,251,233,9,8,1,4,1,3,5,92.82868525896414,3.5856573705179287,3.187250996015936,0.398406374501992,1.593625498007968,0.398406374501992,1.1952191235059761,1.9920318725099602
E00022565,193,184,7,7,0,0,0,0,2,95.33678756476684,3.6269430051813467,3.6269430051813467,0,0,0,0,1.0362694300518136
E00022566,249,234,12,10,2,1,1,0,2,93.97590361445783,4.819277108433735,4.016064257028113,0.8032128514056224,0.4016064257028112,0.4016064257028112,0,0.8032128514056224
E00022567,289,270,11,8,3,3,1,2,5,93.42560553633218,3.8062283737024223,2.768166089965398,1.0380622837370241,1.0380622837370241,0.34602076124567477,0.6920415224913495,1.7301038062283738
E00022568,267,258,1,1,0,7,2,5,1,96.62921348314607,0.37453183520599254,0.37453183520599254,0,2.6217228464419478,0.7490636704119851,1.8726591760299627,0.37453183520599254
E00022569,288,279,6,6,0,3,1,2,0,96.875,2.083333333333333,2.083333333333333,0,1.0416666666666665,0.3472222222222222,0.6944444444444444,0
E00022570,255,236,8,5,3,5,2,3,6,92.54901960784314,3.1372549019607843,1.9607843137254901,1.1764705882352942,1.9607843137254901,0.7843137254901961,1.1764705882352942,2.3529411764705883
E00022571,272,258,10,7,3,2,1,1,2,94.85294117647058,3.6764705882352944,2.5735294117647056,1.1029411764705883,0.7352941176470588,0.3676470588235294,0.3676470588235294,0.7352941176470588
E00022572,219,214,2,2,0,3,3,0,0,97.71689497716895,0.91324200913242,0.91324200913242,0,1.36986301369863,1.36986301369863,0,0
E00022573,197,185,8,8,0,3,2,1,1,93.90862944162437,4.060913705583756,4.060913705583756,0,1.5228426395939088,1.015228426395939,0.5076142131979695,0.5076142131979695
E00022574,357,337,13,9,4,6,2,4,1,94.39775910364145,3.6414565826330536,2.5210084033613445,1.1204481792717087,1.680672268907563,0.5602240896358543,1.1204481792717087,0.2801120448179272
E00022575,416,386,7,6,1,4,1,3,19,92.78846153846155,1.6826923076923077,1.4423076923076923,0.2403846153846154,0.9615384615384616,0.2403846153846154,0.7211538461538461,4.567307692307692
E00022576,319,295,10,5,5,5,2,3,9,92.47648902821317,3.1347962382445136,1.5673981191222568,1.5673981191222568,1.5673981191222568,0.6269592476489028,0.9404388714733543,2.8213166144200628
E00022577,289,267,9,5,4,5,2,3,8,92.38754325259517,3.1141868512110724,1.7301038062283738,1.384083044982699,1.7301038062283738,0.6920415224913495,1.0380622837370241,2.768166089965398
E00022579,465,444,16,14,2,3,3,0,2,95.48387096774194,3.4408602150537635,3.010752688172043,0.43010752688172044,0.6451612903225806,0.6451612903225806,0,0.43010752688172044
E00022580,333,309,12,11,1,6,2,4,6,92.7927927927928,3.6036036036036037,3.303303303303303,0.3003003003003003,1.8018018018018018,0.6006006006006006,1.2012012012012012,1.8018018018018018
E00022581,340,324,9,7,2,3,0,3,4,95.29411764705881,2.6470588235294117,2.0588235294117645,0.5882352941176471,0.8823529411764706,0,0.8823529411764706,1.1764705882352942
E00022582,367,326,18,12,6,6,4,2,17,88.8283378746594,4.904632152588556,3.2697547683923704,1.6348773841961852,1.6348773841961852,1.08991825613079,0.544959128065395,4.632152588555858
E00022583,548,501,21,14,7,18,10,8,8,91.42335766423358,3.832116788321168,2.5547445255474455,1.2773722627737227,3.2846715328467155,1.824817518248175,1.4598540145985401,1.4598540145985401
E00022585,352,330,12,10,2,2,0,2,8,93.75,3.4090909090909087,2.840909090909091,0.5681818181818182,0.5681818181818182,0,0.5681818181818182,2.272727272727273
E00022586,236,219,9,9,0,2,0,2,6,92.79661016949152,3.8135593220338984,3.8135593220338984,0,0.847457627118644,0,0.847457627118644,2.5423728813559325
E00022587,211,206,4,4,0,0,0,0,1,97.6303317535545,1.8957345971563981,1.8957345971563981,0,0,0,0,0.47393364928909953
E00022588,187,173,8,4,4,4,0,4,2,92.51336898395722,4.27807486631016,2.13903743315508,2.13903743315508,2.13903743315508,0,2.13903743315508,1.06951871657754
E00022589,396,372,18,17,1,4,4,0,2,93.93939393939394,4.545454545454546,4.292929292929292,0.25252525252525254,1.0101010101010102,1.0101010101010102,0,0.5050505050505051
E00022590,203,195,5,4,1,2,2,0,1,96.05911330049261,2.4630541871921183,1.9704433497536946,0.49261083743842365,0.9852216748768473,0.9852216748768473,0,0.49261083743842365
E00022591,263,247,9,6,3,3,2,1,4,93.91634980988593,3.4220532319391634,2.2813688212927756,1.1406844106463878,1.1406844106463878,0.7604562737642585,0.38022813688212925,1.520912547528517
E00022592,358,323,16,12,4,7,6,1,12,90.22346368715084,4.4692737430167595,3.35195530726257,1.1173184357541899,1.9553072625698324,1.675977653631285,0.27932960893854747,3.35195530726257
E00022593,315,304,9,9,0,1,1,0,1,96.5079365079365,2.857142857142857,2.857142857142857,0,0.31746031746031744,0.31746031746031744,0,0.31746031746031744
E00022594,295,282,11,10,1,1,0,1,1,95.59322033898306,3.728813559322034,3.389830508474576,0.3389830508474576,0.3389830508474576,0,0.3389830508474576,0.3389830508474576
E00022595,222,217,4,2,2,1,0,1,0,97.74774774774775,1.8018018018018018,0.9009009009009009,0.9009009009009009,0.45045045045045046,0,0.45045045045045046,0
E00022596,255,246,4,4,0,3,0,3,2,96.47058823529412,1.5686274509803921,1.5686274509803921,0,1.1764705882352942,0,1.1764705882352942,0.7843137254901961
E00022597,244,231,5,3,2,5,3,2,3,94.67213114754098,2.0491803278688523,1.2295081967213115,0.819672131147541,2.0491803278688523,1.2295081967213115,0.819672131147541,1.2295081967213115
E00022598,298,276,8,5,3,4,3,1,10,92.61744966442953,2.684563758389262,1.6778523489932886,1.006711409395973,1.342281879194631,1.006711409395973,0.33557046979865773,3.3557046979865772
E00022599,298,280,10,7,3,4,3,1,4,93.95973154362416,3.3557046979865772,2.348993288590604,1.006711409395973,1.342281879194631,1.006711409395973,0.33557046979865773,1.342281879194631
E00022600,249,237,9,8,1,0,0,0,3,95.18072289156626,3.614457831325301,3.2128514056224895,0.4016064257028112,0,0,0,1.2048192771084338
E00022601,239,232,4,4,0,3,0,3,0,97.07112970711297,1.6736401673640167,1.6736401673640167,0,1.2552301255230125,0,1.2552301255230125,0
E00022603,307,293,8,3,5,4,3,1,2,95.43973941368078,2.6058631921824107,0.9771986970684038,1.6286644951140066,1.3029315960912053,0.9771986970684038,0.32573289902280134,0.6514657980456027
E00022604,339,317,13,11,2,1,1,0,8,93.5103244837758,3.8348082595870205,3.2448377581120944,0.5899705014749262,0.2949852507374631,0.2949852507374631,0,2.359882005899705
E00022605,238,224,8,8,0,4,3,1,2,94.11764705882352,3.361344537815126,3.361344537815126,0,1.680672268907563,1.2605042016806722,0.42016806722689076,0.8403361344537815
E00022606,338,309,6,4,2,8,3,5,15,91.42011834319527,1.7751479289940828,1.183431952662722,0.591715976331361,2.366863905325444,0.8875739644970414,1.4792899408284024,4.437869822485207
E00022607,233,226,4,3,1,0,0,0,3,96.99570815450643,1.7167381974248928,1.2875536480686696,0.4291845493562232,0,0,0,1.2875536480686696
E00022608,230,218,3,2,1,3,3,0,6,94.78260869565217,1.3043478260869565,0.8695652173913043,0.43478260869565216,1.3043478260869565,1.3043478260869565,0,2.608695652173913
E00022609,288,279,3,3,0,3,0,3,3,96.875,1.0416666666666665,1.0416666666666665,0,1.0416666666666665,0,1.0416666666666665,1.0416666666666665
E00022610,270,260,2,0,2,1,1,0,7,96.29629629629629,0.7407407407407408,0,0.7407407407407408,0.3703703703703704,0.3703703703703704,0,2.5925925925925926
E00022611,303,293,3,3,0,4,0,4,3,96.69966996699671,0.9900990099009901,0.9900990099009901,0,1.3201320132013201,0,1.3201320132013201,0.9900990099009901
E00022612,395,365,16,9,7,10,4,6,4,92.40506329113924,4.050632911392405,2.278481012658228,1.7721518987341773,2.5316455696202533,1.0126582278481013,1.5189873417721518,1.0126582278481013
E00022613,280,264,6,5,1,2,2,0,8,94.28571428571428,2.142857142857143,1.7857142857142856,0.35714285714285715,0.7142857142857143,0.7142857142857143,0,2.857142857142857
E00022614,274,255,12,10,2,4,2,2,3,93.06569343065694,4.37956204379562,3.64963503649635,0.7299270072992701,1.4598540145985401,0.7299270072992701,0.7299270072992701,1.094890510948905
E00022615,382,367,12,11,1,1,0,1,2,96.07329842931938,3.1413612565445024,2.8795811518324608,0.2617801047120419,0.2617801047120419,0,0.2617801047120419,0.5235602094240838
E00022616,317,287,14,8,6,11,6,5,5,90.53627760252367,4.416403785488959,2.5236593059936907,1.8927444794952681,3.4700315457413247,1.8927444794952681,1.5772870662460567,1.5772870662460567
E00022618,234,221,8,7,1,3,1,2,2,94.44444444444444,3.418803418803419,2.9914529914529915,0.4273504273504274,1.282051282051282,0.4273504273504274,0.8547008547008548,0.8547008547008548
E00022619,420,405,7,7,0,3,0,3,5,96.42857142857143,1.6666666666666667,1.6666666666666667,0,0.7142857142857143,0,0.7142857142857143,1.1904761904761905
E00022620,281,272,6,1,5,2,2,0,1,96.79715302491103,2.135231316725979,0.3558718861209964,1.7793594306049825,0.7117437722419928,0.7117437722419928,0,0.3558718861209964
E00022621,280,267,5,5,0,4,2,2,4,95.35714285714286,1.7857142857142856,1.7857142857142856,0,1.4285714285714286,0.7142857142857143,0.7142857142857143,1.4285714285714286
E00022622,429,384,15,9,6,11,4,7,19,89.5104895104895,3.4965034965034967,2.097902097902098,1.3986013986013985,2.564102564102564,0.9324009324009324,1.6317016317016315,4.428904428904429
E00022623,360,343,5,5,0,6,5,1,6,95.27777777777777,1.3888888888888888,1.3888888888888888,0,1.6666666666666667,1.3888888888888888,0.2777777777777778,1.6666666666666667
E00022624,226,215,6,6,0,2,2,0,3,95.13274336283186,2.6548672566371683,2.6548672566371683,0,0.8849557522123894,0.8849557522123894,0,1.3274336283185841
E00022625,303,283,10,6,4,3,2,1,7,93.3993399339934,3.3003300330033,1.9801980198019802,1.3201320132013201,0.9900990099009901,0.6600660066006601,0.33003300330033003,2.31023102310231
E00022626,271,262,4,3,1,2,2,0,3,96.6789667896679,1.4760147601476015,1.107011070110701,0.36900369003690037,0.7380073800738007,0.7380073800738007,0,1.107011070110701
E00022627,258,247,8,7,1,1,0,1,2,95.73643410852713,3.10077519379845,2.7131782945736433,0.3875968992248062,0.3875968992248062,0,0.3875968992248062,0.7751937984496124
E00022628,281,263,11,8,3,5,1,4,2,93.59430604982207,3.9145907473309607,2.8469750889679712,1.0676156583629894,1.7793594306049825,0.3558718861209964,1.4234875444839856,0.7117437722419928
E00022629,276,262,7,6,1,7,2,5,0,94.92753623188406,2.536231884057971,2.1739130434782608,0.36231884057971014,2.536231884057971,0.7246376811594203,1.8115942028985508,0
E00022630,164,161,1,1,0,1,0,1,1,98.17073170731707,0.6097560975609756,0.6097560975609756,0,0.6097560975609756,0,0.6097560975609756,0.6097560975609756
E00022631,353,345,4,3,1,1,0,1,3,97.73371104815864,1.13314447592068,0.84985835694051,0.28328611898017,0.28328611898017,0,0.28328611898017,0.84985835694051
E00022632,232,213,10,6,4,2,1,1,7,91.8103448275862,4.310344827586207,2.586206896551724,1.7241379310344827,0.8620689655172413,0.43103448275862066,0.43103448275862066,3.0172413793103448
E00022633,198,188,9,5,4,1,0,1,0,94.94949494949495,4.545454545454546,2.525252525252525,2.0202020202020203,0.5050505050505051,0,0.5050505050505051,0
E00022634,332,317,7,4,3,3,1,2,5,95.48192771084338,2.108433734939759,1.2048192771084338,0.9036144578313252,0.9036144578313252,0.30120481927710846,0.6024096385542169,1.5060240963855422
E00022635,206,202,3,3,0,0,0,0,1,98.05825242718447,1.4563106796116505,1.4563106796116505,0,0,0,0,0.48543689320388345
E00022636,248,233,8,5,3,1,0,1,6,93.95161290322581,3.225806451612903,2.0161290322580645,1.2096774193548387,0.4032258064516129,0,0.4032258064516129,2.4193548387096775
E00022637,217,207,6,5,1,3,0,3,1,95.39170506912443,2.7649769585253456,2.3041474654377883,0.4608294930875576,1.3824884792626728,0,1.3824884792626728,0.4608294930875576
E00022638,248,237,7,7,0,1,1,0,3,95.56451612903226,2.82258064516129,2.82258064516129,0,0.4032258064516129,0.4032258064516129,0,1.2096774193548387
E00022639,372,351,11,7,4,6,3,3,4,94.35483870967742,2.956989247311828,1.881720430107527,1.0752688172043012,1.6129032258064515,0.8064516129032258,0.8064516129032258,1.0752688172043012
E00022640,301,287,9,7,2,4,1,3,1,95.34883720930233,2.990033222591362,2.3255813953488373,0.6644518272425249,1.3289036544850499,0.33222591362126247,0.9966777408637874,0.33222591362126247
E00022641,299,286,5,2,3,4,4,0,4,95.65217391304348,1.6722408026755853,0.6688963210702341,1.0033444816053512,1.3377926421404682,1.3377926421404682,0,1.3377926421404682
E00022642,300,282,7,4,3,5,1,4,6,94,2.3333333333333335,1.3333333333333335,1,1.6666666666666667,0.33333333333333337,1.3333333333333335,2
E00022643,329,307,15,12,3,2,1,1,5,93.3130699088146,4.5592705167173255,3.64741641337386,0.911854103343465,0.60790273556231,0.303951367781155,0.303951367781155,1.5197568389057752
E00022644,255,247,5,4,1,1,0,1,2,96.86274509803921,1.9607843137254901,1.5686274509803921,0.39215686274509803,0.39215686274509803,0,0.39215686274509803,0.7843137254901961
E00022645,219,212,5,5,0,2,2,0,0,96.80365296803653,2.28310502283105,2.28310502283105,0,0.91324200913242,0.91324200913242,0,0
E00022646,305,289,13,12,1,2,2,0,1,94.75409836065573,4.2622950819672125,3.934426229508197,0.32786885245901637,0.6557377049180327,0.6557377049180327,0,0.32786885245901637
E00022647,226,216,5,3,2,1,1,0,4,95.57522123893806,2.2123893805309733,1.3274336283185841,0.8849557522123894,0.4424778761061947,0.4424778761061947,0,1.7699115044247788
E00022648,249,241,4,3,1,0,0,0,4,96.78714859437751,1.6064257028112447,1.2048192771084338,0.4016064257028112,0,0,0,1.6064257028112447
E00022650,342,327,5,5,0,4,4,0,6,95.6140350877193,1.461988304093567,1.461988304093567,0,1.1695906432748537,1.1695906432748537,0,1.7543859649122806
E00022651,312,292,11,11,0,5,1,4,4,93.58974358974359,3.5256410256410255,3.5256410256410255,0,1.6025641025641024,0.3205128205128205,1.282051282051282,1.282051282051282
E00022652,324,298,10,7,3,7,4,3,9,91.9753086419753,3.0864197530864197,2.1604938271604937,0.9259259259259258,2.1604938271604937,1.2345679012345678,0.9259259259259258,2.7777777777777777
E00022653,257,245,5,4,1,2,0,2,5,95.3307392996109,1.9455252918287937,1.556420233463035,0.38910505836575876,0.7782101167315175,0,0.7782101167315175,1.9455252918287937
E00022654,294,278,11,10,1,1,1,0,4,94.5578231292517,3.741496598639456,3.4013605442176873,0.3401360544217687,0.3401360544217687,0.3401360544217687,0,1.3605442176870748
E00022655,318,302,14,12,2,2,2,0,0,94.9685534591195,4.40251572327044,3.7735849056603774,0.628930817610063,0.628930817610063,0.628930817610063,0,0
E00022656,297,278,15,12,3,2,0,2,2,93.60269360269359,5.05050505050505,4.040404040404041,1.0101010101010102,0.6734006734006733,0,0.6734006734006733,0.6734006734006733
E00022657,290,263,19,18,1,6,3,3,2,90.6896551724138,6.551724137931035,6.206896551724138,0.3448275862068966,2.0689655172413794,1.0344827586206897,1.0344827586206897,0.6896551724137931
E00022658,266,247,15,12,3,1,1,0,3,92.85714285714286,5.639097744360902,4.511278195488721,1.1278195488721803,0.37593984962406013,0.37593984962406013,0,1.1278195488721803
E00022659,299,282,11,11,0,3,2,1,3,94.31438127090301,3.678929765886288,3.678929765886288,0,1.0033444816053512,0.6688963210702341,0.33444816053511706,1.0033444816053512
E00022660,265,244,12,12,0,3,1,2,6,92.0754716981132,4.528301886792453,4.528301886792453,0,1.1320754716981132,0.37735849056603776,0.7547169811320755,2.2641509433962264
E00022661,226,221,1,1,0,3,1,2,1,97.78761061946902,0.4424778761061947,0.4424778761061947,0,1.3274336283185841,0.4424778761061947,0.8849557522123894,0.4424778761061947
E00022662,296,282,8,6,2,3,2,1,3,95.27027027027027,2.7027027027027026,2.027027027027027,0.6756756756756757,1.0135135135135136,0.6756756756756757,0.33783783783783783,1.0135135135135136
E00022663,250,232,10,8,2,5,3,2,3,92.80000000000001,4,3.2,0.8,2,1.2,0.8,1.2
E00022664,260,237,15,13,2,5,2,3,3,91.15384615384615,5.769230769230769,5,0.7692307692307693,1.9230769230769231,0.7692307692307693,1.153846153846154,1.153846153846154
E00022665,262,249,7,5,2,3,0,3,3,95.0381679389313,2.6717557251908395,1.9083969465648856,0.7633587786259541,1.1450381679389312,0,1.1450381679389312,1.1450381679389312
E00022666,238,217,12,8,4,4,2,2,5,91.17647058823529,5.042016806722689,3.361344537815126,1.680672268907563,1.680672268907563,0.8403361344537815,0.8403361344537815,2.100840336134454
E00022667,448,429,9,7,2,4,2,2,6,95.75892857142857,2.0089285714285716,1.5625,0.4464285714285714,0.8928571428571428,0.4464285714285714,0.4464285714285714,1.3392857142857142
E00022668,296,277,11,7,4,4,2,2,4,93.58108108108108,3.7162162162162162,2.364864864864865,1.3513513513513513,1.3513513513513513,0.6756756756756757,0.6756756756756757,1.3513513513513513
E00022669,333,330,2,2,0,0,0,0,1,99.09909909909909,0.6006006006006006,0.6006006006006006,0,0,0,0,0.3003003003003003
E00022672,296,274,12,10,2,5,2,3,5,92.56756756756756,4.054054054054054,3.3783783783783785,0.6756756756756757,1.6891891891891893,0.6756756756756757,1.0135135135135136,1.6891891891891893
E00022673,291,276,9,7,2,3,1,2,3,94.84536082474226,3.0927835051546393,2.405498281786942,0.6872852233676976,1.0309278350515463,0.3436426116838488,0.6872852233676976,1.0309278350515463
E00022674,417,399,8,8,0,4,1,3,6,95.68345323741008,1.9184652278177456,1.9184652278177456,0,0.9592326139088728,0.2398081534772182,0.7194244604316548,1.4388489208633095
E00022675,285,272,7,6,1,2,0,2,4,95.43859649122807,2.456140350877193,2.1052631578947367,0.3508771929824561,0.7017543859649122,0,0.7017543859649122,1.4035087719298245
E00022676,221,204,12,9,3,4,2,2,1,92.3076923076923,5.429864253393665,4.072398190045249,1.3574660633484164,1.809954751131222,0.904977375565611,0.904977375565611,0.4524886877828055
E00022677,440,426,8,7,1,3,1,2,3,96.81818181818181,1.8181818181818181,1.5909090909090908,0.22727272727272727,0.6818181818181818,0.22727272727272727,0.45454545454545453,0.6818181818181818
E00022678,330,316,6,2,4,4,2,2,4,95.75757575757575,1.8181818181818181,0.6060606060606061,1.2121212121212122,1.2121212121212122,0.6060606060606061,0.6060606060606061,1.2121212121212122
E00022679,295,283,5,5,0,4,0,4,3,95.9322033898305,1.694915254237288,1.694915254237288,0,1.3559322033898304,0,1.3559322033898304,1.0169491525423728
E00022680,248,231,10,6,4,3,2,1,4,93.14516129032258,4.032258064516129,2.4193548387096775,1.6129032258064515,1.2096774193548387,0.8064516129032258,0.4032258064516129,1.6129032258064515
E00022681,184,167,9,7,2,3,3,0,5,90.76086956521739,4.891304347826087,3.804347826086957,1.0869565217391304,1.6304347826086956,1.6304347826086956,0,2.717391304347826
E00022684,288,270,14,13,1,1,1,0,3,93.75,4.861111111111112,4.513888888888888,0.3472222222222222,0.3472222222222222,0.3472222222222222,0,1.0416666666666665
E00022685,273,263,9,6,3,0,0,0,1,96.33699633699634,3.296703296703297,2.197802197802198,1.098901098901099,0,0,0,0.3663003663003663
E00022686,206,199,6,6,0,1,0,1,0,96.60194174757282,2.912621359223301,2.912621359223301,0,0.48543689320388345,0,0.48543689320388345,0
E00022688,247,236,6,6,0,4,0,4,1,95.54655870445345,2.42914979757085,2.42914979757085,0,1.6194331983805668,0,1.6194331983805668,0.4048582995951417
E00022689,271,250,15,11,4,1,1,0,5,92.25092250922509,5.535055350553505,4.059040590405904,1.4760147601476015,0.36900369003690037,0.36900369003690037,0,1.8450184501845017
E00022690,273,263,4,3,1,3,0,3,3,96.33699633699634,1.465201465201465,1.098901098901099,0.3663003663003663,1.098901098901099,0,1.098901098901099,1.098901098901099
E00022691,275,262,8,5,3,3,2,1,2,95.27272727272728,2.909090909090909,1.8181818181818181,1.090909090909091,1.090909090909091,0.7272727272727273,0.36363636363636365,0.7272727272727273
E00022692,381,353,14,9,5,5,2,3,9,92.6509186351706,3.674540682414698,2.3622047244094486,1.3123359580052494,1.3123359580052494,0.5249343832020997,0.7874015748031495,2.3622047244094486
E00022693,243,237,0,0,0,3,1,2,3,97.53086419753086,0,0,0,1.2345679012345678,0.411522633744856,0.823045267489712,1.2345679012345678
E00022694,243,235,5,5,0,2,1,1,1,96.70781893004116,2.05761316872428,2.05761316872428,0,0.823045267489712,0.411522633744856,0.411522633744856,0.411522633744856
E00022695,301,283,10,7,3,2,1,1,6,94.01993355481729,3.322259136212625,2.3255813953488373,0.9966777408637874,0.6644518272425249,0.33222591362126247,0.33222591362126247,1.9933554817275747
E00022696,257,240,9,9,0,1,1,0,7,93.3852140077821,3.501945525291829,3.501945525291829,0,0.38910505836575876,0.38910505836575876,0,2.7237354085603114
E00022697,278,262,12,7,5,2,1,1,2,94.24460431654677,4.316546762589928,2.5179856115107913,1.7985611510791366,0.7194244604316548,0.3597122302158274,0.3597122302158274,0.7194244604316548
E00022698,239,223,11,7,4,3,0,3,2,93.30543933054393,4.602510460251046,2.928870292887029,1.6736401673640167,1.2552301255230125,0,1.2552301255230125,0.8368200836820083
E00022699,265,256,5,4,1,2,1,1,2,96.60377358490567,1.8867924528301887,1.509433962264151,0.37735849056603776,0.7547169811320755,0.37735849056603776,0.37735849056603776,0.7547169811320755
E00022700,312,302,3,2,1,4,0,4,3,96.7948717948718,0.9615384615384616,0.641025641025641,0.3205128205128205,1.282051282051282,0,1.282051282051282,0.9615384615384616
E00022701,289,273,10,9,1,2,1,1,4,94.4636678200692,3.4602076124567476,3.1141868512110724,0.34602076124567477,0.6920415224913495,0.34602076124567477,0.34602076124567477,1.384083044982699
E00022702,241,224,12,10,2,2,0,2,3,92.9460580912863,4.979253112033195,4.149377593360995,0.8298755186721992,0.8298755186721992,0,0.8298755186721992,1.2448132780082988
E00022703,281,267,5,5,0,3,2,1,6,95.01779359430606,1.7793594306049825,1.7793594306049825,0,1.0676156583629894,0.7117437722419928,0.3558718861209964,2.135231316725979
E00022704,255,237,5,3,2,8,5,3,5,92.94117647058823,1.9607843137254901,1.1764705882352942,0.7843137254901961,3.1372549019607843,1.9607843137254901,1.1764705882352942,1.9607843137254901
E00022705,278,264,8,5,3,2,1,1,4,94.96402877697841,2.877697841726619,1.7985611510791366,1.079136690647482,0.7194244604316548,0.3597122302158274,0.3597122302158274,1.4388489208633095
E00022706,297,283,7,3,4,4,2,2,3,95.28619528619528,2.356902356902357,1.0101010101010102,1.3468013468013467,1.3468013468013467,0.6734006734006733,0.6734006734006733,1.0101010101010102
E00022707,360,332,14,7,7,8,3,5,6,92.22222222222223,3.888888888888889,1.9444444444444444,1.9444444444444444,2.2222222222222223,0.8333333333333334,1.3888888888888888,1.6666666666666667
E00022708,344,322,7,5,2,7,2,5,8,93.6046511627907,2.0348837209302326,1.4534883720930232,0.5813953488372093,2.0348837209302326,0.5813953488372093,1.4534883720930232,2.3255813953488373
E00022709,231,217,11,10,1,1,0,1,2,93.93939393939394,4.761904761904762,4.329004329004329,0.4329004329004329,0.4329004329004329,0,0.4329004329004329,0.8658008658008658
E00022710,272,265,6,5,1,1,0,1,0,97.42647058823529,2.2058823529411766,1.8382352941176472,0.3676470588235294,0.3676470588235294,0,0.3676470588235294,0
E00022711,394,385,5,5,0,2,0,2,2,97.71573604060913,1.2690355329949239,1.2690355329949239,0,0.5076142131979695,0,0.5076142131979695,0.5076142131979695
E00022712,319,289,13,10,3,13,7,6,4,90.59561128526646,4.075235109717868,3.1347962382445136,0.9404388714733543,4.075235109717868,2.19435736677116,1.8808777429467085,1.2539184952978055
E00022713,272,258,10,6,4,3,2,1,1,94.85294117647058,3.6764705882352944,2.2058823529411766,1.4705882352941175,1.1029411764705883,0.7352941176470588,0.3676470588235294,0.3676470588235294
E00022714,417,407,3,3,0,5,3,2,2,97.60191846522783,0.7194244604316548,0.7194244604316548,0,1.1990407673860912,0.7194244604316548,0.4796163069544364,0.4796163069544364
E00022716,295,271,12,8,4,7,1,6,5,91.86440677966101,4.067796610169491,2.711864406779661,1.3559322033898304,2.3728813559322033,0.3389830508474576,2.0338983050847457,1.694915254237288
E00022717,197,181,6,2,4,3,1,2,7,91.87817258883248,3.0456852791878175,1.015228426395939,2.030456852791878,1.5228426395939088,0.5076142131979695,1.015228426395939,3.5532994923857872
E00022718,286,266,15,13,2,1,1,0,4,93.00699300699301,5.244755244755245,4.545454545454546,0.6993006993006993,0.34965034965034963,0.34965034965034963,0,1.3986013986013985
E00022719,300,282,12,9,3,2,1,1,4,94,4,3,1,0.6666666666666667,0.33333333333333337,0.33333333333333337,1.3333333333333335
E00022720,500,481,16,14,2,2,0,2,1,96.2,3.2,2.8000000000000003,0.4,0.4,0,0.4,0.2
E00022721,276,257,11,6,5,6,3,3,2,93.11594202898551,3.985507246376811,2.1739130434782608,1.8115942028985508,2.1739130434782608,1.0869565217391304,1.0869565217391304,0.7246376811594203
E00022722,349,334,10,10,0,3,2,1,2,95.70200573065902,2.865329512893983,2.865329512893983,0,0.8595988538681949,0.5730659025787965,0.28653295128939826,0.5730659025787965
E00022723,280,261,9,9,0,7,6,1,3,93.21428571428572,3.214285714285714,3.214285714285714,0,2.5,2.142857142857143,0.35714285714285715,1.0714285714285714
E00022724,259,253,3,3,0,1,0,1,2,97.68339768339769,1.1583011583011582,1.1583011583011582,0,0.3861003861003861,0,0.3861003861003861,0.7722007722007722
E00022726,353,321,13,9,4,5,3,2,14,90.93484419263456,3.6827195467422094,2.5495750708215295,1.13314447592068,1.41643059490085,0.84985835694051,0.56657223796034,3.9660056657223794
E00022727,303,283,6,6,0,10,8,2,4,93.3993399339934,1.9801980198019802,1.9801980198019802,0,3.3003300330033,2.6402640264026402,0.6600660066006601,1.3201320132013201
E00022728,417,383,18,9,9,8,5,3,8,91.84652278177458,4.316546762589928,2.158273381294964,2.158273381294964,1.9184652278177456,1.1990407673860912,0.7194244604316548,1.9184652278177456
E00022729,331,310,11,5,6,7,2,5,3,93.65558912386706,3.3232628398791544,1.5105740181268883,1.812688821752266,2.1148036253776437,0.6042296072507553,1.5105740181268883,0.906344410876133
E00022730,452,404,18,14,4,14,7,7,16,89.38053097345133,3.982300884955752,3.0973451327433628,0.8849557522123894,3.0973451327433628,1.5486725663716814,1.5486725663716814,3.5398230088495577
E00022731,257,242,5,4,1,2,2,0,8,94.16342412451361,1.9455252918287937,1.556420233463035,0.38910505836575876,0.7782101167315175,0.7782101167315175,0,3.11284046692607
E00022732,333,314,7,6,1,8,4,4,4,94.29429429429429,2.1021021021021022,1.8018018018018018,0.3003003003003003,2.4024024024024024,1.2012012012012012,1.2012012012012012,1.2012012012012012
E00022733,413,366,8,7,1,16,5,11,23,88.61985472154964,1.937046004842615,1.694915254237288,0.24213075060532688,3.87409200968523,1.2106537530266344,2.663438256658596,5.569007263922518
E00022734,173,160,7,5,2,4,3,1,2,92.48554913294798,4.046242774566474,2.8901734104046244,1.1560693641618496,2.312138728323699,1.7341040462427744,0.5780346820809248,1.1560693641618496
E00022735,172,161,7,6,1,3,2,1,1,93.6046511627907,4.069767441860465,3.488372093023256,0.5813953488372093,1.744186046511628,1.1627906976744187,0.5813953488372093,0.5813953488372093
E00022736,263,240,10,4,6,7,4,3,6,91.25475285171103,3.802281368821293,1.520912547528517,2.2813688212927756,2.6615969581749046,1.520912547528517,1.1406844106463878,2.2813688212927756
E00022737,323,298,14,13,1,6,2,4,5,92.26006191950464,4.3343653250774,4.024767801857585,0.30959752321981426,1.8575851393188854,0.6191950464396285,1.238390092879257,1.5479876160990713
E00022738,256,243,7,6,1,3,1,2,3,94.921875,2.734375,2.34375,0.390625,1.171875,0.390625,0.78125,1.171875
E00022739,287,269,6,6,0,8,5,3,4,93.72822299651567,2.0905923344947737,2.0905923344947737,0,2.7874564459930316,1.7421602787456445,1.0452961672473868,1.3937282229965158
E00022740,185,174,6,3,3,2,1,1,3,94.05405405405406,3.2432432432432434,1.6216216216216217,1.6216216216216217,1.0810810810810811,0.5405405405405406,0.5405405405405406,1.6216216216216217
E00022741,291,265,12,10,2,5,1,4,9,91.06529209621993,4.123711340206185,3.436426116838488,0.6872852233676976,1.718213058419244,0.3436426116838488,1.3745704467353952,3.0927835051546393
E00022742,339,304,19,13,6,7,4,3,9,89.67551622418878,5.604719764011799,3.8348082595870205,1.7699115044247788,2.0648967551622417,1.1799410029498525,0.8849557522123894,2.6548672566371683
E00022743,329,299,19,14,5,6,1,5,5,90.88145896656535,5.775075987841945,4.25531914893617,1.5197568389057752,1.82370820668693,0.303951367781155,1.5197568389057752,1.5197568389057752
E00022744,338,328,5,5,0,0,0,0,5,97.0414201183432,1.4792899408284024,1.4792899408284024,0,0,0,0,1.4792899408284024
E00022745,380,355,17,11,6,5,1,4,3,93.42105263157895,4.473684210526316,2.8947368421052633,1.5789473684210527,1.3157894736842104,0.2631578947368421,1.0526315789473684,0.7894736842105263
E00022746,347,328,7,6,1,5,1,4,7,94.52449567723343,2.0172910662824206,1.729106628242075,0.2881844380403458,1.440922190201729,0.2881844380403458,1.1527377521613833,2.0172910662824206
E00022747,362,324,26,19,7,5,3,2,7,89.50276243093923,7.18232044198895,5.248618784530387,1.9337016574585635,1.3812154696132597,0.8287292817679558,0.5524861878453038,1.9337016574585635
E00022748,348,327,6,4,2,7,4,3,8,93.96551724137932,1.7241379310344827,1.1494252873563218,0.5747126436781609,2.0114942528735633,1.1494252873563218,0.8620689655172413,2.2988505747126435
E00022749,320,307,10,5,5,2,0,2,1,95.9375,3.125,1.5625,1.5625,0.625,0,0.625,0.3125
E00022750,554,530,19,13,6,3,1,2,2,95.66787003610109,3.429602888086643,2.3465703971119134,1.083032490974729,0.5415162454873645,0.18050541516245489,0.36101083032490977,0.36101083032490977
E00022751,406,392,6,3,3,3,2,1,5,96.55172413793103,1.477832512315271,0.7389162561576355,0.7389162561576355,0.7389162561576355,0.49261083743842365,0.24630541871921183,1.2315270935960592
E00022752,377,347,18,15,3,4,2,2,8,92.04244031830238,4.774535809018567,3.978779840848806,0.7957559681697612,1.0610079575596816,0.5305039787798408,0.5305039787798408,2.122015915119363
E00022753,309,283,14,10,4,5,3,2,7,91.58576051779936,4.53074433656958,3.2362459546925564,1.2944983818770228,1.6181229773462782,0.9708737864077669,0.6472491909385114,2.26537216828479
E00022754,314,294,12,8,4,1,1,0,7,93.63057324840764,3.821656050955414,2.547770700636943,1.2738853503184715,0.3184713375796179,0.3184713375796179,0,2.229299363057325
E00022755,305,287,9,9,0,4,1,3,5,94.09836065573771,2.9508196721311477,2.9508196721311477,0,1.3114754098360655,0.32786885245901637,0.9836065573770493,1.639344262295082
E00022756,319,295,19,17,2,2,1,1,3,92.47648902821317,5.956112852664576,5.329153605015674,0.6269592476489028,0.6269592476489028,0.3134796238244514,0.3134796238244514,0.9404388714733543
E00022757,337,310,19,14,5,3,1,2,5,91.98813056379822,5.637982195845697,4.154302670623145,1.483679525222552,0.8902077151335311,0.2967359050445104,0.5934718100890208,1.483679525222552
E00022758,238,220,7,3,4,5,0,5,6,92.43697478991596,2.941176470588235,1.2605042016806722,1.680672268907563,2.100840336134454,0,2.100840336134454,2.5210084033613445
E00022759,459,423,16,10,6,6,4,2,14,92.15686274509804,3.485838779956427,2.178649237472767,1.3071895424836601,1.3071895424836601,0.8714596949891068,0.4357298474945534,3.0501089324618738
E00022760,550,523,14,10,4,5,5,0,8,95.0909090909091,2.5454545454545454,1.8181818181818181,0.7272727272727273,0.9090909090909091,0.9090909090909091,0,1.4545454545454546
E00022761,404,370,19,13,6,5,0,5,10,91.58415841584159,4.702970297029703,3.217821782178218,1.4851485148514851,1.2376237623762376,0,1.2376237623762376,2.4752475247524752
E00022762,473,447,13,7,6,4,2,2,9,94.5031712473573,2.748414376321353,1.4799154334038054,1.2684989429175475,0.8456659619450317,0.42283298097251587,0.42283298097251587,1.9027484143763214
E00022763,277,253,9,7,2,9,4,5,6,91.33574007220217,3.2490974729241873,2.527075812274368,0.7220216606498195,3.2490974729241873,1.444043321299639,1.8050541516245486,2.166064981949458
E00022764,288,268,11,8,3,2,0,2,7,93.05555555555556,3.8194444444444446,2.7777777777777777,1.0416666666666665,0.6944444444444444,0,0.6944444444444444,2.430555555555556
E00022765,388,368,12,10,2,3,1,2,5,94.84536082474226,3.0927835051546393,2.5773195876288657,0.5154639175257731,0.7731958762886598,0.25773195876288657,0.5154639175257731,1.2886597938144329
E00022766,316,288,12,6,6,5,2,3,11,91.13924050632912,3.79746835443038,1.89873417721519,1.89873417721519,1.5822784810126582,0.6329113924050633,0.949367088607595,3.481012658227848
E00022767,312,283,13,12,1,7,3,4,9,90.7051282051282,4.166666666666666,3.8461538461538463,0.3205128205128205,2.2435897435897436,0.9615384615384616,1.282051282051282,2.8846153846153846
E00022768,300,279,15,12,3,3,1,2,3,93,5,4,1,1,0.33333333333333337,0.6666666666666667,1
E00022769,241,230,6,2,4,5,5,0,0,95.4356846473029,2.4896265560165975,0.8298755186721992,1.6597510373443984,2.0746887966804977,2.0746887966804977,0,0
E00022770,273,257,7,4,3,9,4,5,0,94.13919413919413,2.564102564102564,1.465201465201465,1.098901098901099,3.296703296703297,1.465201465201465,1.8315018315018317,0
E00022771,328,304,9,5,4,9,4,5,6,92.6829268292683,2.7439024390243905,1.524390243902439,1.2195121951219512,2.7439024390243905,1.2195121951219512,1.524390243902439,1.8292682926829267
E00022773,275,263,5,2,3,2,0,2,5,95.63636363636364,1.8181818181818181,0.7272727272727273,1.090909090909091,0.7272727272727273,0,0.7272727272727273,1.8181818181818181
E00022774,260,253,4,2,2,3,1,2,0,97.3076923076923,1.5384615384615385,0.7692307692307693,0.7692307692307693,1.153846153846154,0.38461538461538464,0.7692307692307693,0
E00022775,491,446,20,14,6,16,10,6,9,90.83503054989816,4.0733197556008145,2.8513238289205702,1.2219959266802443,3.2586558044806515,2.0366598778004072,1.2219959266802443,1.8329938900203666
E00022776,315,298,7,3,4,2,1,1,8,94.6031746031746,2.2222222222222223,0.9523809523809524,1.2698412698412698,0.6349206349206349,0.31746031746031744,0.31746031746031744,2.5396825396825395
E00022777,291,268,13,10,3,3,0,3,7,92.09621993127148,4.4673539518900345,3.436426116838488,1.0309278350515463,1.0309278350515463,0,1.0309278350515463,2.405498281786942
E00022778,265,250,8,6,2,3,1,2,4,94.33962264150944,3.018867924528302,2.2641509433962264,0.7547169811320755,1.1320754716981132,0.37735849056603776,0.7547169811320755,1.509433962264151
E00022779,489,463,16,13,3,6,4,2,4,94.68302658486708,3.2719836400818,2.658486707566462,0.6134969325153374,1.2269938650306749,0.81799591002045,0.408997955010225,0.81799591002045
E00022780,467,457,5,4,1,4,0,4,1,97.85867237687366,1.070663811563169,0.8565310492505354,0.21413276231263384,0.8565310492505354,0,0.8565310492505354,0.21413276231263384
E00022781,374,345,16,10,6,6,3,3,7,92.24598930481284,4.27807486631016,2.6737967914438503,1.6042780748663104,1.6042780748663104,0.8021390374331552,0.8021390374331552,1.8716577540106951
E00022782,242,224,8,7,1,7,4,3,3,92.56198347107438,3.3057851239669422,2.8925619834710745,0.4132231404958678,2.8925619834710745,1.6528925619834711,1.2396694214876034,1.2396694214876034
E00022783,202,188,6,5,1,3,1,2,5,93.06930693069307,2.9702970297029703,2.4752475247524752,0.49504950495049505,1.4851485148514851,0.49504950495049505,0.9900990099009901,2.4752475247524752
E00022784,283,271,10,7,3,2,1,1,0,95.75971731448763,3.53356890459364,2.4734982332155475,1.0600706713780919,0.7067137809187279,0.35335689045936397,0.35335689045936397,0
E00022785,280,271,5,4,1,3,2,1,1,96.78571428571429,1.7857142857142856,1.4285714285714286,0.35714285714285715,1.0714285714285714,0.7142857142857143,0.35714285714285715,0.35714285714285715
E00022786,170,157,2,1,1,5,2,3,6,92.3529411764706,1.1764705882352942,0.5882352941176471,0.5882352941176471,2.941176470588235,1.1764705882352942,1.7647058823529411,3.5294117647058822
E00022787,318,308,7,3,4,3,3,0,0,96.85534591194968,2.20125786163522,0.9433962264150944,1.257861635220126,0.9433962264150944,0.9433962264150944,0,0
E00022788,261,241,10,7,3,7,5,2,3,92.33716475095785,3.8314176245210727,2.681992337164751,1.1494252873563218,2.681992337164751,1.9157088122605364,0.7662835249042145,1.1494252873563218
E00022789,340,325,8,6,2,0,0,0,7,95.58823529411765,2.3529411764705883,1.7647058823529411,0.5882352941176471,0,0,0,2.0588235294117645
E00022790,335,304,10,8,2,9,7,2,12,90.74626865671642,2.9850746268656714,2.3880597014925375,0.5970149253731344,2.6865671641791042,2.0895522388059704,0.5970149253731344,3.582089552238806
E00022791,484,453,17,10,7,9,6,3,5,93.59504132231406,3.512396694214876,2.066115702479339,1.4462809917355373,1.859504132231405,1.2396694214876034,0.6198347107438017,1.0330578512396695
E00022793,283,270,8,7,1,1,0,1,4,95.40636042402826,2.8268551236749118,2.4734982332155475,0.35335689045936397,0.35335689045936397,0,0.35335689045936397,1.4134275618374559
E00022794,316,300,10,5,5,2,0,2,4,94.9367088607595,3.1645569620253164,1.5822784810126582,1.5822784810126582,0.6329113924050633,0,0.6329113924050633,1.2658227848101267
E00022796,248,236,9,8,1,3,1,2,0,95.16129032258065,3.6290322580645165,3.225806451612903,0.4032258064516129,1.2096774193548387,0.4032258064516129,0.8064516129032258,0
E00022797,276,259,7,1,6,4,3,1,6,93.84057971014492,2.536231884057971,0.36231884057971014,2.1739130434782608,1.4492753623188406,1.0869565217391304,0.36231884057971014,2.1739130434782608
E00022798,292,276,7,5,2,8,5,3,1,94.52054794520548,2.3972602739726026,1.7123287671232876,0.684931506849315,2.73972602739726,1.7123287671232876,1.0273972602739725,0.3424657534246575
E00022799,283,265,11,10,1,1,0,1,6,93.63957597173145,3.8869257950530036,3.53356890459364,0.35335689045936397,0.35335689045936397,0,0.35335689045936397,2.1201413427561837
E00022800,252,233,5,1,4,6,3,3,8,92.46031746031747,1.984126984126984,0.3968253968253968,1.5873015873015872,2.380952380952381,1.1904761904761905,1.1904761904761905,3.1746031746031744
E00022801,235,225,3,0,3,3,3,0,4,95.74468085106383,1.276595744680851,0,1.276595744680851,1.276595744680851,1.276595744680851,0,1.702127659574468
E00022802,204,190,5,2,3,3,2,1,6,93.13725490196079,2.450980392156863,0.9803921568627451,1.4705882352941175,1.4705882352941175,0.9803921568627451,0.49019607843137253,2.941176470588235
E00022803,286,266,5,5,0,6,3,3,9,93.00699300699301,1.7482517482517483,1.7482517482517483,0,2.097902097902098,1.048951048951049,1.048951048951049,3.146853146853147
E00022804,223,208,6,5,1,5,2,3,4,93.27354260089686,2.690582959641256,2.242152466367713,0.4484304932735426,2.242152466367713,0.8968609865470852,1.345291479820628,1.7937219730941705
E00022805,348,326,7,6,1,8,4,4,7,93.67816091954023,2.0114942528735633,1.7241379310344827,0.28735632183908044,2.2988505747126435,1.1494252873563218,1.1494252873563218,2.0114942528735633
E00022806,297,271,11,8,3,10,5,5,5,91.24579124579124,3.7037037037037033,2.6936026936026933,1.0101010101010102,3.3670033670033668,1.6835016835016834,1.6835016835016834,1.6835016835016834
E00022807,276,254,11,8,3,7,1,6,4,92.02898550724638,3.985507246376811,2.898550724637681,1.0869565217391304,2.536231884057971,0.36231884057971014,2.1739130434782608,1.4492753623188406
E00022808,380,357,15,8,7,4,3,1,4,93.94736842105263,3.9473684210526314,2.1052631578947367,1.8421052631578945,1.0526315789473684,0.7894736842105263,0.2631578947368421,1.0526315789473684
E00022809,338,313,13,11,2,7,3,4,5,92.60355029585799,3.8461538461538463,3.2544378698224854,0.591715976331361,2.0710059171597637,0.8875739644970414,1.183431952662722,1.4792899408284024
E00022810,343,326,8,5,3,3,2,1,6,95.04373177842565,2.3323615160349855,1.4577259475218658,0.8746355685131195,0.8746355685131195,0.5830903790087464,0.2915451895043732,1.749271137026239
E00022811,368,344,11,8,3,5,3,2,8,93.47826086956522,2.989130434782609,2.1739130434782608,0.8152173913043478,1.358695652173913,0.8152173913043478,0.5434782608695652,2.1739130434782608
E00022812,383,356,8,6,2,5,4,1,14,92.95039164490862,2.088772845953003,1.5665796344647518,0.5221932114882507,1.3054830287206265,1.0443864229765014,0.26109660574412535,3.6553524804177546
E00022813,380,366,10,9,1,3,2,1,1,96.3157894736842,2.631578947368421,2.368421052631579,0.2631578947368421,0.7894736842105263,0.5263157894736842,0.2631578947368421,0.2631578947368421
E00022814,312,300,8,6,2,2,2,0,2,96.15384615384616,2.564102564102564,1.9230769230769231,0.641025641025641,0.641025641025641,0.641025641025641,0,0.641025641025641
E00022815,358,324,14,12,2,7,4,3,13,90.5027932960894,3.910614525139665,3.35195530726257,0.5586592178770949,1.9553072625698324,1.1173184357541899,0.8379888268156425,3.6312849162011176
E00022816,243,224,4,3,1,1,1,0,14,92.18106995884774,1.646090534979424,1.2345679012345678,0.411522633744856,0.411522633744856,0.411522633744856,0,5.761316872427984
E00022817,345,322,6,3,3,7,2,5,10,93.33333333333333,1.7391304347826086,0.8695652173913043,0.8695652173913043,2.0289855072463765,0.5797101449275363,1.4492753623188406,2.898550724637681
E00022818,264,246,5,3,2,3,2,1,10,93.18181818181817,1.893939393939394,1.1363636363636365,0.7575757575757576,1.1363636363636365,0.7575757575757576,0.3787878787878788,3.787878787878788
E00022819,360,350,7,7,0,2,1,1,1,97.22222222222221,1.9444444444444444,1.9444444444444444,0,0.5555555555555556,0.2777777777777778,0.2777777777777778,0.2777777777777778
E00022820,184,173,5,2,3,1,1,0,5,94.02173913043478,2.717391304347826,1.0869565217391304,1.6304347826086956,0.5434782608695652,0.5434782608695652,0,2.717391304347826
E00022821,458,436,11,6,5,5,1,4,6,95.19650655021834,2.4017467248908297,1.3100436681222707,1.0917030567685588,1.0917030567685588,0.21834061135371177,0.8733624454148471,1.3100436681222707
E00022822,220,199,10,4,6,6,3,3,5,90.45454545454545,4.545454545454546,1.8181818181818181,2.727272727272727,2.727272727272727,1.3636363636363635,1.3636363636363635,2.272727272727273
E00022823,337,320,9,5,4,5,3,2,3,94.95548961424333,2.6706231454005933,1.483679525222552,1.1869436201780417,1.483679525222552,0.8902077151335311,0.5934718100890208,0.8902077151335311
E00022824,306,296,8,7,1,0,0,0,2,96.73202614379085,2.6143790849673203,2.287581699346405,0.32679738562091504,0,0,0,0.6535947712418301
E00022825,308,290,6,5,1,8,3,5,4,94.15584415584416,1.948051948051948,1.6233766233766231,0.3246753246753247,2.5974025974025974,0.974025974025974,1.6233766233766231,1.2987012987012987
E00022826,311,283,8,6,2,16,4,12,4,90.9967845659164,2.572347266881029,1.929260450160772,0.6430868167202572,5.144694533762058,1.2861736334405145,3.858520900321544,1.2861736334405145
E00022827,333,303,13,8,5,8,4,4,9,90.990990990991,3.903903903903904,2.4024024024024024,1.5015015015015014,2.4024024024024024,1.2012012012012012,1.2012012012012012,2.7027027027027026
E00022828,309,287,9,6,3,4,4,0,9,92.88025889967638,2.912621359223301,1.9417475728155338,0.9708737864077669,1.2944983818770228,1.2944983818770228,0,2.912621359223301
E00022829,527,520,5,4,1,2,0,2,0,98.67172675521822,0.9487666034155597,0.7590132827324478,0.18975332068311196,0.3795066413662239,0,0.3795066413662239,0
E00022830,353,337,9,7,2,4,2,2,3,95.46742209631728,2.5495750708215295,1.9830028328611897,0.56657223796034,1.13314447592068,0.56657223796034,0.56657223796034,0.84985835694051
E00022831,224,205,3,1,2,6,2,4,10,91.51785714285714,1.3392857142857142,0.4464285714285714,0.8928571428571428,2.6785714285714284,0.8928571428571428,1.7857142857142856,4.464285714285714
E00022832,303,280,15,12,3,3,2,1,5,92.4092409240924,4.9504950495049505,3.9603960396039604,0.9900990099009901,0.9900990099009901,0.6600660066006601,0.33003300330033003,1.65016501650165
E00022833,386,361,8,6,2,8,4,4,9,93.52331606217616,2.072538860103627,1.5544041450777202,0.5181347150259068,2.072538860103627,1.0362694300518136,1.0362694300518136,2.33160621761658
E00022834,321,288,14,9,5,7,2,5,12,89.7196261682243,4.361370716510903,2.803738317757009,1.557632398753894,2.1806853582554515,0.6230529595015576,1.557632398753894,3.7383177570093453
E00022835,244,233,7,3,4,0,0,0,4,95.49180327868852,2.8688524590163933,1.2295081967213115,1.639344262295082,0,0,0,1.639344262295082
E00022836,467,444,14,11,3,7,5,2,2,95.07494646680942,2.9978586723768736,2.355460385438972,0.6423982869379015,1.4989293361884368,1.070663811563169,0.4282655246252677,0.4282655246252677
E00022838,449,423,16,8,8,8,7,1,2,94.20935412026726,3.5634743875278394,1.7817371937639197,1.7817371937639197,1.7817371937639197,1.55902004454343,0.22271714922048996,0.4454342984409799
E00022839,378,356,9,4,5,7,4,3,6,94.17989417989418,2.380952380952381,1.0582010582010581,1.3227513227513228,1.8518518518518516,1.0582010582010581,0.7936507936507936,1.5873015873015872
E00022840,285,266,8,6,2,5,1,4,6,93.33333333333333,2.807017543859649,2.1052631578947367,0.7017543859649122,1.7543859649122806,0.3508771929824561,1.4035087719298245,2.1052631578947367
E00022841,249,233,2,2,0,8,4,4,6,93.57429718875501,0.8032128514056224,0.8032128514056224,0,3.2128514056224895,1.6064257028112447,1.6064257028112447,2.4096385542168677
E00022843,412,375,14,11,3,18,4,14,5,91.01941747572816,3.3980582524271843,2.669902912621359,0.7281553398058253,4.368932038834951,0.9708737864077669,3.3980582524271843,1.2135922330097086
E00022844,253,239,4,4,0,1,1,0,9,94.46640316205533,1.5810276679841897,1.5810276679841897,0,0.3952569169960474,0.3952569169960474,0,3.557312252964427
E00022845,225,217,4,4,0,4,1,3,0,96.44444444444444,1.7777777777777777,1.7777777777777777,0,1.7777777777777777,0.4444444444444444,1.3333333333333335,0
E00022846,231,204,12,8,4,7,5,2,8,88.31168831168831,5.194805194805195,3.463203463203463,1.7316017316017316,3.0303030303030303,2.1645021645021645,0.8658008658008658,3.463203463203463
E00022847,230,220,3,2,1,5,3,2,2,95.65217391304348,1.3043478260869565,0.8695652173913043,0.43478260869565216,2.1739130434782608,1.3043478260869565,0.8695652173913043,0.8695652173913043
E00022848,326,301,12,11,1,8,5,3,5,92.33128834355828,3.6809815950920246,3.374233128834356,0.3067484662576687,2.4539877300613497,1.5337423312883436,0.9202453987730062,1.5337423312883436
E00022849,391,369,12,10,2,4,2,2,6,94.37340153452686,3.0690537084398977,2.557544757033248,0.5115089514066496,1.0230179028132993,0.5115089514066496,0.5115089514066496,1.5345268542199488
E00022850,352,341,7,4,3,2,0,2,2,96.875,1.9886363636363635,1.1363636363636365,0.8522727272727272,0.5681818181818182,0,0.5681818181818182,0.5681818181818182
E00022851,316,291,10,7,3,6,1,5,9,92.08860759493672,3.1645569620253164,2.2151898734177213,0.949367088607595,1.89873417721519,0.31645569620253167,1.5822784810126582,2.848101265822785
E00022852,244,226,8,6,2,4,1,3,6,92.62295081967213,3.278688524590164,2.459016393442623,0.819672131147541,1.639344262295082,0.4098360655737705,1.2295081967213115,2.459016393442623
E00022853,373,357,14,14,0,1,0,1,1,95.71045576407506,3.753351206434316,3.753351206434316,0,0.2680965147453083,0,0.2680965147453083,0.2680965147453083
E00022854,255,234,10,8,2,6,2,4,5,91.76470588235294,3.9215686274509802,3.1372549019607843,0.7843137254901961,2.3529411764705883,0.7843137254901961,1.5686274509803921,1.9607843137254901
E00022855,271,257,6,5,1,5,3,2,3,94.8339483394834,2.214022140221402,1.8450184501845017,0.36900369003690037,1.8450184501845017,1.107011070110701,0.7380073800738007,1.107011070110701
E00022856,192,178,8,8,0,1,0,1,5,92.70833333333334,4.166666666666666,4.166666666666666,0,0.5208333333333333,0,0.5208333333333333,2.604166666666667
E00022857,415,397,8,6,2,10,4,6,0,95.66265060240964,1.9277108433734942,1.4457831325301205,0.48192771084337355,2.4096385542168677,0.9638554216867471,1.4457831325301205,0
E00022858,335,321,10,9,1,2,1,1,2,95.82089552238806,2.9850746268656714,2.6865671641791042,0.2985074626865672,0.5970149253731344,0.2985074626865672,0.2985074626865672,0.5970149253731344
E00022862,302,284,12,9,3,0,0,0,6,94.03973509933775,3.9735099337748347,2.980132450331126,0.9933774834437087,0,0,0,1.9867549668874174
E00022863,316,288,16,8,8,7,3,4,5,91.13924050632912,5.063291139240507,2.5316455696202533,2.5316455696202533,2.2151898734177213,0.949367088607595,1.2658227848101267,1.5822784810126582
E00022864,293,277,8,3,5,5,1,4,3,94.53924914675767,2.7303754266211606,1.023890784982935,1.7064846416382253,1.7064846416382253,0.3412969283276451,1.3651877133105803,1.023890784982935
E00022865,339,324,6,6,0,3,1,2,6,95.57522123893806,1.7699115044247788,1.7699115044247788,0,0.8849557522123894,0.2949852507374631,0.5899705014749262,1.7699115044247788
E00022866,205,195,6,6,0,3,2,1,1,95.1219512195122,2.9268292682926833,2.9268292682926833,0,1.4634146341463417,0.975609756097561,0.4878048780487805,0.4878048780487805
E00022867,295,273,14,12,2,3,1,2,5,92.54237288135593,4.745762711864407,4.067796610169491,0.6779661016949152,1.0169491525423728,0.3389830508474576,0.6779661016949152,1.694915254237288
E00022868,312,298,12,11,1,1,0,1,1,95.51282051282051,3.8461538461538463,3.5256410256410255,0.3205128205128205,0.3205128205128205,0,0.3205128205128205,0.3205128205128205
E00022869,372,368,2,2,0,2,0,2,0,98.9247311827957,0.5376344086021506,0.5376344086021506,0,0.5376344086021506,0,0.5376344086021506,0
E00022871,416,397,13,8,5,1,1,0,5,95.4326923076923,3.125,1.9230769230769231,1.201923076923077,0.2403846153846154,0.2403846153846154,0,1.201923076923077
E00022872,340,329,9,9,0,2,1,1,0,96.76470588235294,2.6470588235294117,2.6470588235294117,0,0.5882352941176471,0.29411764705882354,0.29411764705882354,0
E00022873,263,254,5,5,0,4,4,0,0,96.57794676806084,1.9011406844106464,1.9011406844106464,0,1.520912547528517,1.520912547528517,0,0
E00022874,150,143,6,2,4,0,0,0,1,95.33333333333334,4,1.3333333333333335,2.666666666666667,0,0,0,0.6666666666666667
E00022875,332,314,15,10,5,1,1,0,2,94.57831325301204,4.518072289156627,3.0120481927710845,1.5060240963855422,0.30120481927710846,0.30120481927710846,0,0.6024096385542169
E00022876,193,184,5,5,0,3,2,1,1,95.33678756476684,2.5906735751295336,2.5906735751295336,0,1.5544041450777202,1.0362694300518136,0.5181347150259068,0.5181347150259068
E00022877,342,295,12,6,6,9,2,7,26,86.25730994152046,3.508771929824561,1.7543859649122806,1.7543859649122806,2.631578947368421,0.5847953216374269,2.046783625730994,7.602339181286549
E00022878,177,172,5,5,0,0,0,0,0,97.17514124293785,2.824858757062147,2.824858757062147,0,0,0,0,0
E00022879,235,221,9,7,2,2,1,1,3,94.04255319148936,3.829787234042553,2.9787234042553195,0.851063829787234,0.851063829787234,0.425531914893617,0.425531914893617,1.276595744680851
E00022880,240,221,16,12,4,2,2,0,1,92.08333333333333,6.666666666666667,5,1.6666666666666667,0.8333333333333334,0.8333333333333334,0,0.4166666666666667
E00022881,268,258,7,5,2,1,1,0,2,96.26865671641791,2.6119402985074625,1.8656716417910446,0.7462686567164178,0.3731343283582089,0.3731343283582089,0,0.7462686567164178
E00022882,260,237,13,12,1,3,2,1,7,91.15384615384615,5,4.615384615384616,0.38461538461538464,1.153846153846154,0.7692307692307693,0.38461538461538464,2.6923076923076925
E00022884,210,199,6,6,0,5,3,2,0,94.76190476190476,2.857142857142857,2.857142857142857,0,2.380952380952381,1.4285714285714286,0.9523809523809524,0
E00022885,261,248,11,11,0,2,0,2,0,95.01915708812261,4.21455938697318,4.21455938697318,0,0.7662835249042145,0,0.7662835249042145,0
E00022886,302,286,9,8,1,7,4,3,0,94.70198675496688,2.980132450331126,2.6490066225165565,0.33112582781456956,2.3178807947019866,1.3245033112582782,0.9933774834437087,0
E00022887,277,265,9,6,3,1,0,1,2,95.66787003610109,3.2490974729241873,2.166064981949458,1.083032490974729,0.36101083032490977,0,0.36101083032490977,0.7220216606498195
E00022888,213,206,3,3,0,2,0,2,2,96.71361502347418,1.4084507042253522,1.4084507042253522,0,0.9389671361502347,0,0.9389671361502347,0.9389671361502347
E00022889,243,225,13,10,3,1,1,0,4,92.5925925925926,5.349794238683128,4.11522633744856,1.2345679012345678,0.411522633744856,0.411522633744856,0,1.646090534979424
E00022890,377,363,9,7,2,5,1,4,0,96.28647214854111,2.3872679045092835,1.8567639257294428,0.5305039787798408,1.3262599469496021,0.2652519893899204,1.0610079575596816,0
E00022891,240,221,12,9,3,2,0,2,5,92.08333333333333,5,3.75,1.25,0.8333333333333334,0,0.8333333333333334,2.083333333333333
E00022892,256,245,4,1,3,3,2,1,4,95.703125,1.5625,0.390625,1.171875,1.171875,0.78125,0.390625,1.5625
E00022893,324,307,7,7,0,4,1,3,6,94.75308641975309,2.1604938271604937,2.1604938271604937,0,1.2345679012345678,0.30864197530864196,0.9259259259259258,1.8518518518518516
E00022894,407,384,11,6,5,4,2,2,8,94.34889434889435,2.7027027027027026,1.4742014742014742,1.2285012285012284,0.9828009828009828,0.4914004914004914,0.4914004914004914,1.9656019656019657
E00022895,203,196,5,1,4,0,0,0,2,96.55172413793103,2.4630541871921183,0.49261083743842365,1.9704433497536946,0,0,0,0.9852216748768473
E00022896,391,373,10,10,0,5,4,1,3,95.39641943734016,2.557544757033248,2.557544757033248,0,1.278772378516624,1.0230179028132993,0.2557544757033248,0.7672634271099744
E00022897,181,166,8,8,0,3,0,3,4,91.71270718232044,4.41988950276243,4.41988950276243,0,1.6574585635359116,0,1.6574585635359116,2.209944751381215
E00022898,332,313,13,13,0,3,0,3,3,94.27710843373494,3.91566265060241,3.91566265060241,0,0.9036144578313252,0,0.9036144578313252,0.9036144578313252
E00022900,224,214,8,8,0,2,2,0,0,95.53571428571429,3.571428571428571,3.571428571428571,0,0.8928571428571428,0.8928571428571428,0,0
E00022901,214,199,10,10,0,2,2,0,3,92.99065420560748,4.672897196261682,4.672897196261682,0,0.9345794392523363,0.9345794392523363,0,1.4018691588785046
E00022902,134,131,1,1,0,1,0,1,1,97.76119402985076,0.7462686567164178,0.7462686567164178,0,0.7462686567164178,0,0.7462686567164178,0.7462686567164178
E00022903,244,226,11,5,6,3,3,0,4,92.62295081967213,4.508196721311475,2.0491803278688523,2.459016393442623,1.2295081967213115,1.2295081967213115,0,1.639344262295082
E00022904,283,273,7,7,0,2,2,0,1,96.46643109540636,2.4734982332155475,2.4734982332155475,0,0.7067137809187279,0.7067137809187279,0,0.35335689045936397
E00022905,319,305,8,6,2,3,1,2,3,95.61128526645768,2.507836990595611,1.8808777429467085,0.6269592476489028,0.9404388714733543,0.3134796238244514,0.6269592476489028,0.9404388714733543
E00022906,170,157,9,8,1,2,0,2,2,92.3529411764706,5.294117647058823,4.705882352941177,0.5882352941176471,1.1764705882352942,0,1.1764705882352942,1.1764705882352942
E00022907,317,282,19,13,6,5,2,3,11,88.95899053627761,5.993690851735016,4.100946372239748,1.8927444794952681,1.5772870662460567,0.6309148264984227,0.9463722397476341,3.4700315457413247
E00022908,318,298,12,10,2,4,1,3,4,93.71069182389937,3.7735849056603774,3.1446540880503147,0.628930817610063,1.257861635220126,0.3144654088050315,0.9433962264150944,1.257861635220126
E00022909,288,271,12,8,4,3,1,2,2,94.09722222222221,4.166666666666666,2.7777777777777777,1.3888888888888888,1.0416666666666665,0.3472222222222222,0.6944444444444444,0.6944444444444444
E00022910,376,362,9,6,3,3,1,2,2,96.27659574468085,2.393617021276596,1.5957446808510638,0.7978723404255319,0.7978723404255319,0.26595744680851063,0.5319148936170213,0.5319148936170213
E00022911,269,261,4,4,0,2,0,2,2,97.02602230483272,1.486988847583643,1.486988847583643,0,0.7434944237918215,0,0.7434944237918215,0.7434944237918215
E00022912,144,136,5,2,3,0,0,0,3,94.44444444444444,3.4722222222222223,1.3888888888888888,2.083333333333333,0,0,0,2.083333333333333
E00022914,450,440,7,7,0,3,1,2,0,97.77777777777777,1.5555555555555556,1.5555555555555556,0,0.6666666666666667,0.2222222222222222,0.4444444444444444,0
E00022915,213,208,5,5,0,0,0,0,0,97.65258215962442,2.3474178403755865,2.3474178403755865,0,0,0,0,0
E00022916,311,296,7,3,4,5,3,2,3,95.17684887459808,2.2508038585209005,0.964630225080386,1.2861736334405145,1.607717041800643,0.964630225080386,0.6430868167202572,0.964630225080386
E00022917,285,270,12,12,0,2,0,2,1,94.73684210526315,4.2105263157894735,4.2105263157894735,0,0.7017543859649122,0,0.7017543859649122,0.3508771929824561
E00022919,299,296,2,1,1,0,0,0,1,98.99665551839465,0.6688963210702341,0.33444816053511706,0.33444816053511706,0,0,0,0.33444816053511706
E00022920,277,269,5,5,0,1,1,0,2,97.11191335740072,1.8050541516245486,1.8050541516245486,0,0.36101083032490977,0.36101083032490977,0,0.7220216606498195
E00022921,206,199,4,4,0,2,2,0,1,96.60194174757282,1.9417475728155338,1.9417475728155338,0,0.9708737864077669,0.9708737864077669,0,0.48543689320388345
E00022922,312,295,9,7,2,2,1,1,6,94.55128205128204,2.8846153846153846,2.2435897435897436,0.641025641025641,0.641025641025641,0.3205128205128205,0.3205128205128205,1.9230769230769231
E00022923,263,256,5,4,1,2,0,2,0,97.33840304182509,1.9011406844106464,1.520912547528517,0.38022813688212925,0.7604562737642585,0,0.7604562737642585,0
E00022924,296,289,4,3,1,3,2,1,0,97.63513513513513,1.3513513513513513,1.0135135135135136,0.33783783783783783,1.0135135135135136,0.6756756756756757,0.33783783783783783,0
E00022925,199,191,3,2,1,4,2,2,1,95.97989949748744,1.507537688442211,1.0050251256281406,0.5025125628140703,2.0100502512562812,1.0050251256281406,1.0050251256281406,0.5025125628140703
E00022926,290,277,6,3,3,4,3,1,3,95.51724137931035,2.0689655172413794,1.0344827586206897,1.0344827586206897,1.3793103448275863,1.0344827586206897,0.3448275862068966,1.0344827586206897
E00022927,350,338,11,9,2,1,0,1,0,96.57142857142857,3.1428571428571432,2.571428571428571,0.5714285714285714,0.2857142857142857,0,0.2857142857142857,0
E00022928,388,375,5,5,0,1,0,1,7,96.64948453608247,1.2886597938144329,1.2886597938144329,0,0.25773195876288657,0,0.25773195876288657,1.804123711340206
E00022929,294,285,8,5,3,1,1,0,0,96.93877551020408,2.7210884353741496,1.7006802721088436,1.0204081632653061,0.3401360544217687,0.3401360544217687,0,0
E00022930,293,273,13,12,1,4,2,2,3,93.1740614334471,4.436860068259386,4.09556313993174,0.3412969283276451,1.3651877133105803,0.6825938566552902,0.6825938566552902,1.023890784982935
E00022931,378,363,10,10,0,4,3,1,1,96.03174603174604,2.6455026455026456,2.6455026455026456,0,1.0582010582010581,0.7936507936507936,0.26455026455026454,0.26455026455026454
E00022932,377,357,14,10,4,1,1,0,5,94.6949602122016,3.7135278514588856,2.6525198938992043,1.0610079575596816,0.2652519893899204,0.2652519893899204,0,1.3262599469496021
E00022933,375,350,16,14,2,4,2,2,5,93.33333333333333,4.266666666666667,3.733333333333334,0.5333333333333333,1.0666666666666667,0.5333333333333333,0.5333333333333333,1.3333333333333335
E00022934,338,318,11,11,0,4,0,4,5,94.0828402366864,3.2544378698224854,3.2544378698224854,0,1.183431952662722,0,1.183431952662722,1.4792899408284024
E00022935,269,259,6,5,1,2,1,1,2,96.28252788104089,2.2304832713754648,1.858736059479554,0.37174721189591076,0.7434944237918215,0.37174721189591076,0.37174721189591076,0.7434944237918215
E00022936,366,346,11,9,2,2,2,0,7,94.53551912568307,3.0054644808743167,2.459016393442623,0.546448087431694,0.546448087431694,0.546448087431694,0,1.912568306010929
E00022937,356,340,9,9,0,5,4,1,2,95.50561797752809,2.528089887640449,2.528089887640449,0,1.4044943820224718,1.1235955056179776,0.2808988764044944,0.5617977528089888
E00022938,360,340,16,15,1,1,0,1,3,94.44444444444444,4.444444444444445,4.166666666666666,0.2777777777777778,0.2777777777777778,0,0.2777777777777778,0.8333333333333334
E00022939,303,279,16,13,3,5,1,4,3,92.07920792079209,5.2805280528052805,4.29042904290429,0.9900990099009901,1.65016501650165,0.33003300330033003,1.3201320132013201,0.9900990099009901
E00022940,394,388,2,2,0,0,0,0,4,98.47715736040608,0.5076142131979695,0.5076142131979695,0,0,0,0,1.015228426395939
E00022941,343,330,9,7,2,2,0,2,2,96.20991253644316,2.623906705539359,2.0408163265306123,0.5830903790087464,0.5830903790087464,0,0.5830903790087464,0.5830903790087464
E00022942,369,343,22,18,4,2,1,1,2,92.95392953929539,5.9620596205962055,4.878048780487805,1.084010840108401,0.5420054200542005,0.27100271002710025,0.27100271002710025,0.5420054200542005
E00022943,309,300,8,4,4,0,0,0,1,97.0873786407767,2.5889967637540456,1.2944983818770228,1.2944983818770228,0,0,0,0.3236245954692557
E00022944,329,314,10,9,1,5,2,3,0,95.44072948328267,3.0395136778115504,2.735562310030395,0.303951367781155,1.5197568389057752,0.60790273556231,0.911854103343465,0
E00022945,264,251,7,7,0,4,3,1,2,95.07575757575758,2.6515151515151514,2.6515151515151514,0,1.5151515151515151,1.1363636363636365,0.3787878787878788,0.7575757575757576
E00022946,311,299,8,8,0,1,0,1,3,96.14147909967846,2.572347266881029,2.572347266881029,0,0.3215434083601286,0,0.3215434083601286,0.964630225080386
E00022947,279,256,14,11,3,4,2,2,5,91.75627240143369,5.017921146953405,3.942652329749104,1.0752688172043012,1.4336917562724014,0.7168458781362007,0.7168458781362007,1.7921146953405016
E00022948,352,330,14,11,3,1,0,1,7,93.75,3.977272727272727,3.125,0.8522727272727272,0.2840909090909091,0,0.2840909090909091,1.9886363636363635
E00022949,323,315,8,6,2,0,0,0,0,97.52321981424149,2.476780185758514,1.8575851393188854,0.6191950464396285,0,0,0,0
E00022950,409,388,15,14,1,3,1,2,3,94.86552567237165,3.6674816625916873,3.4229828850855744,0.24449877750611246,0.7334963325183375,0.24449877750611246,0.4889975550122249,0.7334963325183375
E00022951,362,349,13,10,3,0,0,0,0,96.40883977900553,3.591160220994475,2.7624309392265194,0.8287292817679558,0,0,0,0
E00022952,197,185,9,8,1,2,0,2,1,93.90862944162437,4.568527918781726,4.060913705583756,0.5076142131979695,1.015228426395939,0,1.015228426395939,0.5076142131979695
E00022953,362,342,8,7,1,6,3,3,6,94.47513812154696,2.209944751381215,1.9337016574585635,0.2762430939226519,1.6574585635359116,0.8287292817679558,0.8287292817679558,1.6574585635359116
E00022954,308,287,6,5,1,6,3,3,9,93.18181818181817,1.948051948051948,1.6233766233766231,0.3246753246753247,1.948051948051948,0.974025974025974,0.974025974025974,2.922077922077922
E00022956,367,350,6,5,1,8,2,6,3,95.36784741144415,1.6348773841961852,1.3623978201634876,0.2724795640326975,2.17983651226158,0.544959128065395,1.6348773841961852,0.8174386920980926
E00022958,216,208,4,0,4,1,1,0,3,96.29629629629629,1.8518518518518516,0,1.8518518518518516,0.4629629629629629,0.4629629629629629,0,1.3888888888888888
E00022959,343,322,12,7,5,5,3,2,4,93.87755102040816,3.498542274052478,2.0408163265306123,1.4577259475218658,1.4577259475218658,0.8746355685131195,0.5830903790087464,1.1661807580174928
E00022960,279,268,5,3,2,6,2,4,0,96.05734767025089,1.7921146953405016,1.0752688172043012,0.7168458781362007,2.1505376344086025,0.7168458781362007,1.4336917562724014,0
E00022961,289,262,7,6,1,11,10,1,9,90.65743944636678,2.422145328719723,2.0761245674740483,0.34602076124567477,3.8062283737024223,3.4602076124567476,0.34602076124567477,3.1141868512110724
E00022962,273,254,9,7,2,5,4,1,5,93.04029304029304,3.296703296703297,2.564102564102564,0.7326007326007326,1.8315018315018317,1.465201465201465,0.3663003663003663,1.8315018315018317
E00022963,234,217,10,10,0,1,0,1,6,92.73504273504274,4.273504273504273,4.273504273504273,0,0.4273504273504274,0,0.4273504273504274,2.564102564102564
E00022964,295,273,16,12,4,1,0,1,5,92.54237288135593,5.423728813559322,4.067796610169491,1.3559322033898304,0.3389830508474576,0,0.3389830508474576,1.694915254237288
E00022965,281,269,6,5,1,3,1,2,3,95.72953736654804,2.135231316725979,1.7793594306049825,0.3558718861209964,1.0676156583629894,0.3558718861209964,0.7117437722419928,1.0676156583629894
E00022966,355,334,12,10,2,2,0,2,7,94.08450704225352,3.3802816901408446,2.8169014084507045,0.5633802816901409,0.5633802816901409,0,0.5633802816901409,1.971830985915493
E00022967,253,244,4,4,0,2,1,1,3,96.44268774703558,1.5810276679841897,1.5810276679841897,0,0.7905138339920948,0.3952569169960474,0.3952569169960474,1.185770750988142
E00022968,271,261,7,6,1,1,0,1,2,96.30996309963099,2.5830258302583027,2.214022140221402,0.36900369003690037,0.36900369003690037,0,0.36900369003690037,0.7380073800738007
E00022969,240,229,8,5,3,2,1,1,1,95.41666666666667,3.3333333333333335,2.083333333333333,1.25,0.8333333333333334,0.4166666666666667,0.4166666666666667,0.4166666666666667
E00022970,254,242,5,4,1,2,2,0,5,95.2755905511811,1.968503937007874,1.574803149606299,0.39370078740157477,0.7874015748031495,0.7874015748031495,0,1.968503937007874
E00022976,397,356,19,15,4,12,5,7,10,89.67254408060454,4.785894206549118,3.7783375314861463,1.0075566750629723,3.022670025188917,1.2594458438287155,1.7632241813602016,2.518891687657431
E00022977,235,222,7,6,1,2,1,1,4,94.46808510638299,2.9787234042553195,2.553191489361702,0.425531914893617,0.851063829787234,0.425531914893617,0.425531914893617,1.702127659574468
E00022978,235,224,5,4,1,3,2,1,3,95.31914893617022,2.127659574468085,1.702127659574468,0.425531914893617,1.276595744680851,0.851063829787234,0.425531914893617,1.276595744680851
E00022979,201,187,8,7,1,1,0,1,5,93.03482587064677,3.9800995024875623,3.482587064676617,0.4975124378109453,0.4975124378109453,0,0.4975124378109453,2.4875621890547266
E00022980,361,332,16,8,8,5,2,3,8,91.96675900277008,4.43213296398892,2.21606648199446,2.21606648199446,1.3850415512465373,0.554016620498615,0.8310249307479225,2.21606648199446
E00022981,256,236,11,6,5,5,2,3,4,92.1875,4.296875,2.34375,1.953125,1.953125,0.78125,1.171875,1.5625
E00022982,333,313,8,7,1,3,3,0,9,93.993993993994,2.4024024024024024,2.1021021021021022,0.3003003003003003,0.9009009009009009,0.9009009009009009,0,2.7027027027027026
E00022983,330,298,17,15,2,13,2,11,2,90.30303030303031,5.151515151515151,4.545454545454546,0.6060606060606061,3.939393939393939,0.6060606060606061,3.3333333333333335,0.6060606060606061
E00022984,340,332,4,2,2,2,1,1,2,97.6470588235294,1.1764705882352942,0.5882352941176471,0.5882352941176471,0.5882352941176471,0.29411764705882354,0.29411764705882354,0.5882352941176471
E00022985,295,275,14,11,3,1,1,0,5,93.22033898305084,4.745762711864407,3.728813559322034,1.0169491525423728,0.3389830508474576,0.3389830508474576,0,1.694915254237288
E00022987,227,219,6,6,0,1,0,1,1,96.47577092511013,2.643171806167401,2.643171806167401,0,0.4405286343612335,0,0.4405286343612335,0.4405286343612335
E00022988,215,194,8,7,1,8,5,3,5,90.23255813953487,3.7209302325581395,3.255813953488372,0.46511627906976744,3.7209302325581395,2.3255813953488373,1.3953488372093024,2.3255813953488373
E00022989,218,205,4,2,2,3,2,1,6,94.03669724770643,1.834862385321101,0.9174311926605505,0.9174311926605505,1.3761467889908259,0.9174311926605505,0.45871559633027525,2.7522935779816518
E00022990,311,285,11,7,4,11,7,4,4,91.63987138263666,3.536977491961415,2.2508038585209005,1.2861736334405145,3.536977491961415,2.2508038585209005,1.2861736334405145,1.2861736334405145
E00022991,308,288,10,8,2,8,4,4,2,93.5064935064935,3.2467532467532463,2.5974025974025974,0.6493506493506493,2.5974025974025974,1.2987012987012987,1.2987012987012987,0.6493506493506493
E00022992,270,258,7,3,4,3,0,3,2,95.55555555555556,2.5925925925925926,1.1111111111111112,1.4814814814814816,1.1111111111111112,0,1.1111111111111112,0.7407407407407408
E00022993,289,255,11,10,1,11,2,9,12,88.23529411764706,3.8062283737024223,3.4602076124567476,0.34602076124567477,3.8062283737024223,0.6920415224913495,3.1141868512110724,4.1522491349480966
E00022994,254,240,10,6,4,3,0,3,1,94.48818897637796,3.937007874015748,2.3622047244094486,1.574803149606299,1.1811023622047243,0,1.1811023622047243,0.39370078740157477
E00022995,379,367,11,9,2,1,0,1,0,96.83377308707124,2.9023746701846966,2.3746701846965697,0.5277044854881267,0.2638522427440633,0,0.2638522427440633,0
E00022996,247,217,15,8,7,8,5,3,7,87.85425101214574,6.0728744939271255,3.2388663967611335,2.834008097165992,3.2388663967611335,2.0242914979757085,1.214574898785425,2.834008097165992
E00022997,350,329,11,4,7,3,3,0,7,94,3.1428571428571432,1.1428571428571428,2,0.8571428571428572,0.8571428571428572,0,2
E00022998,217,206,7,4,3,3,0,3,1,94.93087557603687,3.225806451612903,1.8433179723502304,1.3824884792626728,1.3824884792626728,0,1.3824884792626728,0.4608294930875576
E00022999,214,206,5,4,1,1,1,0,2,96.26168224299066,2.336448598130841,1.8691588785046727,0.46728971962616817,0.46728971962616817,0.46728971962616817,0,0.9345794392523363
E00023000,385,366,13,8,5,4,3,1,2,95.06493506493506,3.3766233766233764,2.0779220779220777,1.2987012987012987,1.0389610389610389,0.7792207792207793,0.2597402597402597,0.5194805194805194
E00023001,444,412,13,7,6,8,3,5,11,92.7927927927928,2.9279279279279278,1.5765765765765765,1.3513513513513513,1.8018018018018018,0.6756756756756757,1.1261261261261262,2.4774774774774775
E00023002,315,290,7,4,3,7,1,6,11,92.06349206349206,2.2222222222222223,1.2698412698412698,0.9523809523809524,2.2222222222222223,0.31746031746031744,1.9047619047619049,3.492063492063492
E00023003,253,238,9,8,1,4,1,3,2,94.0711462450593,3.557312252964427,3.1620553359683794,0.3952569169960474,1.5810276679841897,0.3952569169960474,1.185770750988142,0.7905138339920948
E00023004,332,304,11,11,0,6,1,5,11,91.56626506024097,3.313253012048193,3.313253012048193,0,1.8072289156626504,0.30120481927710846,1.5060240963855422,3.313253012048193
E00023005,601,539,28,14,14,13,8,5,21,89.6838602329451,4.658901830282862,2.329450915141431,2.329450915141431,2.1630615640599005,1.3311148086522462,0.8319467554076538,3.494176372712146
E00023007,304,286,12,10,2,3,1,2,3,94.07894736842105,3.9473684210526314,3.289473684210526,0.6578947368421052,0.9868421052631579,0.3289473684210526,0.6578947368421052,0.9868421052631579
E00023008,384,355,15,9,6,5,3,2,9,92.44791666666666,3.90625,2.34375,1.5625,1.3020833333333335,0.78125,0.5208333333333333,2.34375
E00023009,342,320,9,7,2,6,3,3,7,93.56725146198829,2.631578947368421,2.046783625730994,0.5847953216374269,1.7543859649122806,0.8771929824561403,0.8771929824561403,2.046783625730994
E00023010,355,328,10,6,4,10,3,7,7,92.3943661971831,2.8169014084507045,1.6901408450704223,1.1267605633802817,2.8169014084507045,0.8450704225352111,1.971830985915493,1.971830985915493
E00023011,358,340,11,6,5,3,2,1,4,94.97206703910615,3.072625698324022,1.675977653631285,1.3966480446927374,0.8379888268156425,0.5586592178770949,0.27932960893854747,1.1173184357541899
E00023013,376,358,11,8,3,5,4,1,2,95.2127659574468,2.925531914893617,2.127659574468085,0.7978723404255319,1.3297872340425532,1.0638297872340425,0.26595744680851063,0.5319148936170213
E00023014,378,341,20,16,4,11,1,10,6,90.21164021164022,5.291005291005291,4.232804232804233,1.0582010582010581,2.91005291005291,0.26455026455026454,2.6455026455026456,1.5873015873015872
E00023015,409,391,9,9,0,7,2,5,2,95.59902200488997,2.2004889975550124,2.2004889975550124,0,1.7114914425427872,0.4889975550122249,1.2224938875305624,0.4889975550122249
E00023016,308,293,5,4,1,4,0,4,6,95.12987012987013,1.6233766233766231,1.2987012987012987,0.3246753246753247,1.2987012987012987,0,1.2987012987012987,1.948051948051948
E00023017,257,240,9,6,3,0,0,0,8,93.3852140077821,3.501945525291829,2.3346303501945527,1.1673151750972763,0,0,0,3.11284046692607
E00023018,468,430,13,10,3,10,7,3,15,91.88034188034187,2.7777777777777777,2.1367521367521367,0.641025641025641,2.1367521367521367,1.4957264957264957,0.641025641025641,3.205128205128205
E00023019,425,401,10,2,8,7,3,4,7,94.35294117647058,2.3529411764705883,0.4705882352941176,1.8823529411764703,1.647058823529412,0.7058823529411765,0.9411764705882352,1.647058823529412
E00023020,281,269,5,5,0,1,0,1,6,95.72953736654804,1.7793594306049825,1.7793594306049825,0,0.3558718861209964,0,0.3558718861209964,2.135231316725979
E00023021,260,242,6,5,1,6,2,4,6,93.07692307692308,2.307692307692308,1.9230769230769231,0.38461538461538464,2.307692307692308,0.7692307692307693,1.5384615384615385,2.307692307692308
E00023022,256,238,11,10,1,5,2,3,2,92.96875,4.296875,3.90625,0.390625,1.953125,0.78125,1.171875,0.78125
E00023023,372,342,17,11,6,5,2,3,8,91.93548387096774,4.56989247311828,2.956989247311828,1.6129032258064515,1.3440860215053763,0.5376344086021506,0.8064516129032258,2.1505376344086025
E00023024,283,257,6,5,1,11,4,7,9,90.81272084805654,2.1201413427561837,1.76678445229682,0.35335689045936397,3.8869257950530036,1.4134275618374559,2.4734982332155475,3.180212014134275
E00023025,428,405,8,4,4,10,4,6,5,94.62616822429906,1.8691588785046727,0.9345794392523363,0.9345794392523363,2.336448598130841,0.9345794392523363,1.4018691588785046,1.1682242990654206
E00023026,320,294,14,11,3,3,0,3,9,91.875,4.375,3.4375000000000004,0.9375,0.9375,0,0.9375,2.8125
E00023027,211,198,2,1,1,2,1,1,9,93.8388625592417,0.9478672985781991,0.47393364928909953,0.47393364928909953,0.9478672985781991,0.47393364928909953,0.47393364928909953,4.265402843601896
E00023028,309,285,10,7,3,7,2,5,7,92.23300970873787,3.2362459546925564,2.26537216828479,0.9708737864077669,2.26537216828479,0.6472491909385114,1.6181229773462782,2.26537216828479
E00023029,252,233,10,5,5,3,2,1,6,92.46031746031747,3.968253968253968,1.984126984126984,1.984126984126984,1.1904761904761905,0.7936507936507936,0.3968253968253968,2.380952380952381
E00023030,290,271,9,8,1,6,5,1,4,93.44827586206897,3.103448275862069,2.7586206896551726,0.3448275862068966,2.0689655172413794,1.7241379310344827,0.3448275862068966,1.3793103448275863
E00023031,395,371,6,5,1,4,2,2,14,93.92405063291139,1.5189873417721518,1.2658227848101267,0.25316455696202533,1.0126582278481013,0.5063291139240507,0.5063291139240507,3.5443037974683547
E00023032,510,483,9,8,1,5,4,1,13,94.70588235294117,1.7647058823529411,1.5686274509803921,0.19607843137254902,0.9803921568627451,0.7843137254901961,0.19607843137254902,2.549019607843137
E00023033,374,352,15,11,4,3,2,1,4,94.11764705882352,4.0106951871657754,2.941176470588235,1.06951871657754,0.8021390374331552,0.53475935828877,0.267379679144385,1.06951871657754
E00023034,343,315,7,4,3,14,10,4,7,91.83673469387756,2.0408163265306123,1.1661807580174928,0.8746355685131195,4.081632653061225,2.9154518950437316,1.1661807580174928,2.0408163265306123
E00023035,275,247,11,9,2,6,3,3,11,89.81818181818181,4,3.272727272727273,0.7272727272727273,2.181818181818182,1.090909090909091,1.090909090909091,4
E00023036,310,300,2,1,1,5,2,3,3,96.7741935483871,0.6451612903225806,0.3225806451612903,0.3225806451612903,1.6129032258064515,0.6451612903225806,0.967741935483871,0.967741935483871
E00023037,328,301,10,4,6,8,3,5,9,91.76829268292683,3.048780487804878,1.2195121951219512,1.8292682926829267,2.4390243902439024,0.9146341463414633,1.524390243902439,2.7439024390243905
E00023038,521,505,2,0,2,5,1,4,9,96.92898272552783,0.3838771593090211,0,0.3838771593090211,0.9596928982725527,0.19193857965451055,0.7677543186180422,1.727447216890595
E00023039,358,335,12,11,1,5,3,2,6,93.57541899441341,3.35195530726257,3.072625698324022,0.27932960893854747,1.3966480446927374,0.8379888268156425,0.5586592178770949,1.675977653631285
E00023040,372,347,7,3,4,8,3,5,10,93.27956989247312,1.881720430107527,0.8064516129032258,1.0752688172043012,2.1505376344086025,0.8064516129032258,1.3440860215053763,2.6881720430107525
E00023041,388,374,6,4,2,1,1,0,7,96.3917525773196,1.5463917525773196,1.0309278350515463,0.5154639175257731,0.25773195876288657,0.25773195876288657,0,1.804123711340206
E00023042,349,321,7,4,3,15,1,14,6,91.97707736389685,2.005730659025788,1.146131805157593,0.8595988538681949,4.297994269340974,0.28653295128939826,4.011461318051576,1.7191977077363898
E00023043,223,208,9,5,4,3,0,3,3,93.27354260089686,4.0358744394618835,2.242152466367713,1.7937219730941705,1.345291479820628,0,1.345291479820628,1.345291479820628
E00023044,204,198,4,3,1,1,0,1,1,97.05882352941177,1.9607843137254901,1.4705882352941175,0.49019607843137253,0.49019607843137253,0,0.49019607843137253,0.49019607843137253
E00023045,322,312,6,6,0,0,0,0,4,96.8944099378882,1.8633540372670807,1.8633540372670807,0,0,0,0,1.2422360248447204
E00023046,242,224,8,8,0,7,4,3,3,92.56198347107438,3.3057851239669422,3.3057851239669422,0,2.8925619834710745,1.6528925619834711,1.2396694214876034,1.2396694214876034
E00023047,190,176,11,9,2,1,0,1,2,92.63157894736842,5.7894736842105265,4.736842105263158,1.0526315789473684,0.5263157894736842,0,0.5263157894736842,1.0526315789473684
E00023048,223,211,9,7,2,2,2,0,1,94.61883408071749,4.0358744394618835,3.1390134529147984,0.8968609865470852,0.8968609865470852,0.8968609865470852,0,0.4484304932735426
E00023052,242,229,10,8,2,1,1,0,2,94.62809917355372,4.132231404958678,3.3057851239669422,0.8264462809917356,0.4132231404958678,0.4132231404958678,0,0.8264462809917356
E00023053,216,206,6,6,0,3,0,3,1,95.37037037037037,2.7777777777777777,2.7777777777777777,0,1.3888888888888888,0,1.3888888888888888,0.4629629629629629
E00023054,281,265,13,12,1,1,0,1,2,94.30604982206405,4.6263345195729535,4.270462633451958,0.3558718861209964,0.3558718861209964,0,0.3558718861209964,0.7117437722419928
E00023055,323,304,12,11,1,4,4,0,3,94.11764705882352,3.7151702786377707,3.4055727554179565,0.30959752321981426,1.238390092879257,1.238390092879257,0,0.9287925696594427
E00023056,405,374,15,9,6,10,3,7,6,92.34567901234568,3.7037037037037033,2.2222222222222223,1.4814814814814816,2.4691358024691357,0.7407407407407408,1.728395061728395,1.4814814814814816
E00023057,455,425,22,7,15,3,1,2,5,93.4065934065934,4.835164835164836,1.5384615384615385,3.296703296703297,0.6593406593406593,0.21978021978021978,0.43956043956043955,1.098901098901099
E00023058,394,379,4,3,1,6,4,2,5,96.19289340101524,1.015228426395939,0.7614213197969544,0.25380710659898476,1.5228426395939088,1.015228426395939,0.5076142131979695,1.2690355329949239
E00023059,241,231,7,5,2,0,0,0,3,95.850622406639,2.904564315352697,2.0746887966804977,0.8298755186721992,0,0,0,1.2448132780082988
E00023060,414,384,17,10,7,4,1,3,9,92.7536231884058,4.1062801932367154,2.4154589371980677,1.6908212560386473,0.966183574879227,0.24154589371980675,0.7246376811594203,2.1739130434782608
E00023061,312,289,11,7,4,4,1,3,8,92.62820512820514,3.5256410256410255,2.2435897435897436,1.282051282051282,1.282051282051282,0.3205128205128205,0.9615384615384616,2.564102564102564
E00023062,262,243,5,1,4,9,5,4,5,92.74809160305344,1.9083969465648856,0.38167938931297707,1.5267175572519083,3.435114503816794,1.9083969465648856,1.5267175572519083,1.9083969465648856
E00023063,280,268,5,4,1,3,1,2,4,95.71428571428572,1.7857142857142856,1.4285714285714286,0.35714285714285715,1.0714285714285714,0.35714285714285715,0.7142857142857143,1.4285714285714286
E00023064,303,278,11,8,3,6,0,6,8,91.74917491749174,3.6303630363036308,2.6402640264026402,0.9900990099009901,1.9801980198019802,0,1.9801980198019802,2.6402640264026402
E00023065,337,321,8,4,4,2,1,1,6,95.25222551928783,2.3738872403560833,1.1869436201780417,1.1869436201780417,0.5934718100890208,0.2967359050445104,0.2967359050445104,1.7804154302670623
E00023066,384,357,17,13,4,3,2,1,7,92.96875,4.427083333333334,3.3854166666666665,1.0416666666666665,0.78125,0.5208333333333333,0.26041666666666663,1.8229166666666667
E00023067,325,315,2,2,0,3,2,1,5,96.92307692307692,0.6153846153846154,0.6153846153846154,0,0.9230769230769231,0.6153846153846154,0.3076923076923077,1.5384615384615385
E00023068,307,293,8,6,2,2,0,2,4,95.43973941368078,2.6058631921824107,1.9543973941368076,0.6514657980456027,0.6514657980456027,0,0.6514657980456027,1.3029315960912053
E00023069,372,348,4,0,4,10,5,5,10,93.54838709677419,1.0752688172043012,0,1.0752688172043012,2.6881720430107525,1.3440860215053763,1.3440860215053763,2.6881720430107525
E00023070,306,280,16,10,6,6,4,2,4,91.50326797385621,5.228758169934641,3.2679738562091507,1.9607843137254901,1.9607843137254901,1.3071895424836601,0.6535947712418301,1.3071895424836601
E00023071,357,324,14,8,6,10,5,5,9,90.75630252100841,3.9215686274509802,2.2408963585434174,1.680672268907563,2.801120448179272,1.400560224089636,1.400560224089636,2.5210084033613445
E00023072,283,268,5,3,2,4,2,2,6,94.69964664310953,1.76678445229682,1.0600706713780919,0.7067137809187279,1.4134275618374559,0.7067137809187279,0.7067137809187279,2.1201413427561837
E00023073,302,288,13,10,3,0,0,0,1,95.36423841059603,4.304635761589404,3.3112582781456954,0.9933774834437087,0,0,0,0.33112582781456956
E00023074,343,329,11,11,0,3,2,1,0,95.91836734693877,3.206997084548105,3.206997084548105,0,0.8746355685131195,0.5830903790087464,0.2915451895043732,0
E00023075,466,450,10,10,0,6,6,0,0,96.56652360515021,2.1459227467811157,2.1459227467811157,0,1.2875536480686696,1.2875536480686696,0,0
E00023076,253,245,5,3,2,2,0,2,1,96.83794466403161,1.9762845849802373,1.185770750988142,0.7905138339920948,0.7905138339920948,0,0.7905138339920948,0.3952569169960474
E00023077,218,209,4,3,1,4,2,2,1,95.87155963302753,1.834862385321101,1.3761467889908259,0.45871559633027525,1.834862385321101,0.9174311926605505,0.9174311926605505,0.45871559633027525
E00023079,325,313,9,7,2,3,2,1,0,96.3076923076923,2.769230769230769,2.1538461538461537,0.6153846153846154,0.9230769230769231,0.6153846153846154,0.3076923076923077,0
E00023080,242,229,11,10,1,0,0,0,2,94.62809917355372,4.545454545454546,4.132231404958678,0.4132231404958678,0,0,0,0.8264462809917356
E00023081,182,168,8,8,0,3,1,2,3,92.3076923076923,4.395604395604396,4.395604395604396,0,1.6483516483516485,0.5494505494505495,1.098901098901099,1.6483516483516485
E00023082,299,283,11,6,5,4,1,3,1,94.64882943143813,3.678929765886288,2.0066889632107023,1.6722408026755853,1.3377926421404682,0.33444816053511706,1.0033444816053512,0.33444816053511706
E00023083,259,232,8,6,2,11,6,5,8,89.57528957528957,3.088803088803089,2.3166023166023164,0.7722007722007722,4.247104247104247,2.3166023166023164,1.9305019305019304,3.088803088803089
E00023084,246,241,4,1,3,1,0,1,0,97.96747967479675,1.6260162601626018,0.40650406504065045,1.2195121951219512,0.40650406504065045,0,0.40650406504065045,0
E00023085,247,229,8,7,1,2,2,0,8,92.71255060728745,3.2388663967611335,2.834008097165992,0.4048582995951417,0.8097165991902834,0.8097165991902834,0,3.2388663967611335
E00023086,222,201,8,4,4,5,2,3,8,90.54054054054053,3.6036036036036037,1.8018018018018018,1.8018018018018018,2.2522522522522523,0.9009009009009009,1.3513513513513513,3.6036036036036037
E00023087,264,250,7,4,3,4,2,2,3,94.6969696969697,2.6515151515151514,1.5151515151515151,1.1363636363636365,1.5151515151515151,0.7575757575757576,0.7575757575757576,1.1363636363636365
E00023088,231,221,7,6,1,0,0,0,3,95.67099567099568,3.0303030303030303,2.5974025974025974,0.4329004329004329,0,0,0,1.2987012987012987
E00023089,328,305,8,8,0,11,5,6,4,92.98780487804879,2.4390243902439024,2.4390243902439024,0,3.353658536585366,1.524390243902439,1.8292682926829267,1.2195121951219512
E00023091,313,294,14,11,3,1,1,0,4,93.9297124600639,4.472843450479233,3.5143769968051117,0.9584664536741214,0.3194888178913738,0.3194888178913738,0,1.2779552715654952
E00023092,299,279,11,8,3,7,3,4,2,93.31103678929766,3.678929765886288,2.6755852842809364,1.0033444816053512,2.341137123745819,1.0033444816053512,1.3377926421404682,0.6688963210702341
E00023093,279,244,16,10,6,8,2,6,11,87.45519713261649,5.734767025089606,3.584229390681003,2.1505376344086025,2.867383512544803,0.7168458781362007,2.1505376344086025,3.942652329749104
E00023094,309,298,8,7,1,1,1,0,2,96.44012944983818,2.5889967637540456,2.26537216828479,0.3236245954692557,0.3236245954692557,0.3236245954692557,0,0.6472491909385114
E00023095,391,374,7,7,0,4,2,2,6,95.65217391304348,1.7902813299232736,1.7902813299232736,0,1.0230179028132993,0.5115089514066496,0.5115089514066496,1.5345268542199488
E00023096,407,384,18,14,4,3,2,1,2,94.34889434889435,4.422604422604422,3.43980343980344,0.9828009828009828,0.7371007371007371,0.4914004914004914,0.2457002457002457,0.4914004914004914
E00023097,271,264,3,3,0,2,1,1,2,97.41697416974169,1.107011070110701,1.107011070110701,0,0.7380073800738007,0.36900369003690037,0.36900369003690037,0.7380073800738007
E00023098,266,254,8,6,2,2,1,1,2,95.48872180451127,3.007518796992481,2.2556390977443606,0.7518796992481203,0.7518796992481203,0.37593984962406013,0.37593984962406013,0.7518796992481203
E00023099,278,270,6,6,0,1,1,0,1,97.12230215827337,2.158273381294964,2.158273381294964,0,0.3597122302158274,0.3597122302158274,0,0.3597122302158274
E00023100,352,336,12,9,3,1,0,1,3,95.45454545454545,3.4090909090909087,2.556818181818182,0.8522727272727272,0.2840909090909091,0,0.2840909090909091,0.8522727272727272
E00023101,344,334,8,7,1,1,0,1,1,97.09302325581395,2.3255813953488373,2.0348837209302326,0.29069767441860467,0.29069767441860467,0,0.29069767441860467,0.29069767441860467
E00023102,261,253,6,6,0,1,0,1,1,96.93486590038314,2.2988505747126435,2.2988505747126435,0,0.38314176245210724,0,0.38314176245210724,0.38314176245210724
E00023103,246,227,11,5,6,3,3,0,5,92.27642276422763,4.471544715447155,2.0325203252032518,2.4390243902439024,1.2195121951219512,1.2195121951219512,0,2.0325203252032518
E00023104,319,298,16,11,5,2,0,2,3,93.41692789968651,5.015673981191222,3.4482758620689653,1.5673981191222568,0.6269592476489028,0,0.6269592476489028,0.9404388714733543
E00023105,280,269,9,8,1,2,1,1,0,96.07142857142857,3.214285714285714,2.857142857142857,0.35714285714285715,0.7142857142857143,0.35714285714285715,0.35714285714285715,0
E00023106,331,328,3,2,1,0,0,0,0,99.09365558912387,0.906344410876133,0.6042296072507553,0.3021148036253776,0,0,0,0
E00023107,249,236,12,11,1,0,0,0,1,94.77911646586345,4.819277108433735,4.417670682730924,0.4016064257028112,0,0,0,0.4016064257028112
E00023108,257,250,5,3,2,1,1,0,1,97.27626459143968,1.9455252918287937,1.1673151750972763,0.7782101167315175,0.38910505836575876,0.38910505836575876,0,0.38910505836575876
E00023109,255,244,8,8,0,2,0,2,1,95.68627450980392,3.1372549019607843,3.1372549019607843,0,0.7843137254901961,0,0.7843137254901961,0.39215686274509803
E00023110,323,311,9,8,1,2,0,2,1,96.28482972136223,2.786377708978328,2.476780185758514,0.30959752321981426,0.6191950464396285,0,0.6191950464396285,0.30959752321981426
E00023111,319,310,7,6,1,2,0,2,0,97.17868338557993,2.19435736677116,1.8808777429467085,0.3134796238244514,0.6269592476489028,0,0.6269592476489028,0
E00023112,298,277,10,9,1,3,1,2,8,92.9530201342282,3.3557046979865772,3.0201342281879198,0.33557046979865773,1.006711409395973,0.33557046979865773,0.6711409395973155,2.684563758389262
E00023113,324,295,11,8,3,7,4,3,11,91.0493827160494,3.3950617283950617,2.4691358024691357,0.9259259259259258,2.1604938271604937,1.2345679012345678,0.9259259259259258,3.3950617283950617
E00023114,247,224,10,7,3,5,2,3,8,90.68825910931174,4.048582995951417,2.834008097165992,1.214574898785425,2.0242914979757085,0.8097165991902834,1.214574898785425,3.2388663967611335
E00023115,312,290,6,5,1,8,2,6,8,92.94871794871796,1.9230769230769231,1.6025641025641024,0.3205128205128205,2.564102564102564,0.641025641025641,1.9230769230769231,2.564102564102564
E00023116,244,232,4,3,1,4,2,2,4,95.08196721311475,1.639344262295082,1.2295081967213115,0.4098360655737705,1.639344262295082,0.819672131147541,0.819672131147541,1.639344262295082
E00023117,283,269,8,5,3,5,0,5,1,95.0530035335689,2.8268551236749118,1.76678445229682,1.0600706713780919,1.76678445229682,0,1.76678445229682,0.35335689045936397
E00023118,308,283,10,7,3,8,4,4,7,91.88311688311688,3.2467532467532463,2.272727272727273,0.974025974025974,2.5974025974025974,1.2987012987012987,1.2987012987012987,2.272727272727273
E00023119,248,229,12,7,5,4,1,3,3,92.33870967741935,4.838709677419355,2.82258064516129,2.0161290322580645,1.6129032258064515,0.4032258064516129,1.2096774193548387,1.2096774193548387
E00023120,239,224,2,1,1,11,4,7,2,93.72384937238493,0.8368200836820083,0.41841004184100417,0.41841004184100417,4.602510460251046,1.6736401673640167,2.928870292887029,0.8368200836820083
E00023121,250,224,18,15,3,2,1,1,6,89.60000000000001,7.199999999999999,6,1.2,0.8,0.4,0.4,2.4
E00023122,318,300,4,3,1,9,5,4,5,94.33962264150944,1.257861635220126,0.9433962264150944,0.3144654088050315,2.8301886792452833,1.5723270440251573,1.257861635220126,1.5723270440251573
E00023123,263,237,15,13,2,7,3,4,4,90.11406844106465,5.7034220532319395,4.942965779467681,0.7604562737642585,2.6615969581749046,1.1406844106463878,1.520912547528517,1.520912547528517
E00023124,372,345,11,8,3,7,4,3,9,92.74193548387096,2.956989247311828,2.1505376344086025,0.8064516129032258,1.881720430107527,1.0752688172043012,0.8064516129032258,2.4193548387096775
E00023125,298,281,9,6,3,4,2,2,4,94.29530201342283,3.0201342281879198,2.013422818791946,1.006711409395973,1.342281879194631,0.6711409395973155,0.6711409395973155,1.342281879194631
E00023126,336,323,8,6,2,4,1,3,1,96.13095238095238,2.380952380952381,1.7857142857142856,0.5952380952380952,1.1904761904761905,0.2976190476190476,0.8928571428571428,0.2976190476190476
E00023127,261,227,21,15,6,4,2,2,9,86.97318007662835,8.045977011494253,5.747126436781609,2.2988505747126435,1.532567049808429,0.7662835249042145,0.7662835249042145,3.4482758620689653
E00023128,273,261,7,4,3,3,1,2,2,95.6043956043956,2.564102564102564,1.465201465201465,1.098901098901099,1.098901098901099,0.3663003663003663,0.7326007326007326,0.7326007326007326
E00023129,282,275,3,2,1,3,1,2,1,97.51773049645391,1.0638297872340425,0.7092198581560284,0.3546099290780142,1.0638297872340425,0.3546099290780142,0.7092198581560284,0.3546099290780142
E00023130,247,234,10,9,1,1,0,1,2,94.73684210526315,4.048582995951417,3.643724696356275,0.4048582995951417,0.4048582995951417,0,0.4048582995951417,0.8097165991902834
E00023131,387,374,8,6,2,3,0,3,2,96.64082687338501,2.0671834625323,1.550387596899225,0.516795865633075,0.7751937984496124,0,0.7751937984496124,0.516795865633075
E00023132,274,258,11,7,4,2,1,1,3,94.16058394160584,4.014598540145985,2.5547445255474455,1.4598540145985401,0.7299270072992701,0.36496350364963503,0.36496350364963503,1.094890510948905
E00023133,342,325,10,9,1,2,0,2,5,95.02923976608187,2.923976608187134,2.631578947368421,0.29239766081871343,0.5847953216374269,0,0.5847953216374269,1.461988304093567
E00023134,256,240,9,9,0,4,2,2,3,93.75,3.515625,3.515625,0,1.5625,0.78125,0.78125,1.171875
E00023135,470,455,10,7,3,1,1,0,4,96.80851063829788,2.127659574468085,1.4893617021276597,0.6382978723404255,0.2127659574468085,0.2127659574468085,0,0.851063829787234
E00023136,329,311,10,9,1,5,3,2,3,94.52887537993921,3.0395136778115504,2.735562310030395,0.303951367781155,1.5197568389057752,0.911854103343465,0.60790273556231,0.911854103343465
E00023137,281,267,7,5,2,2,0,2,5,95.01779359430606,2.491103202846975,1.7793594306049825,0.7117437722419928,0.7117437722419928,0,0.7117437722419928,1.7793594306049825
E00023138,240,229,7,6,1,2,2,0,2,95.41666666666667,2.9166666666666665,2.5,0.4166666666666667,0.8333333333333334,0.8333333333333334,0,0.8333333333333334
E00023140,281,275,4,4,0,0,0,0,2,97.86476868327402,1.4234875444839856,1.4234875444839856,0,0,0,0,0.7117437722419928
E00023141,332,314,14,12,2,2,2,0,2,94.57831325301204,4.216867469879518,3.614457831325301,0.6024096385542169,0.6024096385542169,0.6024096385542169,0,0.6024096385542169
E00023142,276,261,6,3,3,3,2,1,6,94.56521739130434,2.1739130434782608,1.0869565217391304,1.0869565217391304,1.0869565217391304,0.7246376811594203,0.36231884057971014,2.1739130434782608
E00023143,252,241,7,7,0,1,0,1,3,95.63492063492063,2.7777777777777777,2.7777777777777777,0,0.3968253968253968,0,0.3968253968253968,1.1904761904761905
E00023144,323,295,17,16,1,2,0,2,9,91.3312693498452,5.263157894736842,4.953560371517028,0.30959752321981426,0.6191950464396285,0,0.6191950464396285,2.786377708978328
E00023145,225,220,4,4,0,1,0,1,0,97.77777777777777,1.7777777777777777,1.7777777777777777,0,0.4444444444444444,0,0.4444444444444444,0
E00023146,282,273,3,3,0,2,2,0,4,96.80851063829788,1.0638297872340425,1.0638297872340425,0,0.7092198581560284,0.7092198581560284,0,1.4184397163120568
E00023147,313,301,8,7,1,3,1,2,1,96.1661341853035,2.5559105431309903,2.2364217252396164,0.3194888178913738,0.9584664536741214,0.3194888178913738,0.6389776357827476,0.3194888178913738
E00023148,244,228,13,13,0,2,1,1,1,93.44262295081968,5.327868852459016,5.327868852459016,0,0.819672131147541,0.4098360655737705,0.4098360655737705,0.4098360655737705
E00023149,277,260,8,4,4,5,3,2,4,93.86281588447653,2.888086642599278,1.444043321299639,1.444043321299639,1.8050541516245486,1.083032490974729,0.7220216606498195,1.444043321299639
E00023151,219,204,7,3,4,3,0,3,5,93.15068493150685,3.1963470319634704,1.36986301369863,1.82648401826484,1.36986301369863,0,1.36986301369863,2.28310502283105
E00023152,375,344,15,5,10,8,2,6,8,91.73333333333333,4,1.3333333333333335,2.666666666666667,2.1333333333333333,0.5333333333333333,1.6,2.1333333333333333
E00023153,394,368,9,5,4,4,1,3,13,93.4010152284264,2.284263959390863,1.2690355329949239,1.015228426395939,1.015228426395939,0.25380710659898476,0.7614213197969544,3.2994923857868024
E00023155,232,212,15,13,2,3,3,0,2,91.37931034482759,6.4655172413793105,5.603448275862069,0.8620689655172413,1.293103448275862,1.293103448275862,0,0.8620689655172413
E00023156,240,233,7,5,2,0,0,0,0,97.08333333333333,2.9166666666666665,2.083333333333333,0.8333333333333334,0,0,0,0
E00023157,215,202,9,7,2,1,1,0,3,93.95348837209302,4.186046511627907,3.255813953488372,0.9302325581395349,0.46511627906976744,0.46511627906976744,0,1.3953488372093024
E00023158,444,399,23,14,9,12,3,9,10,89.86486486486487,5.18018018018018,3.153153153153153,2.027027027027027,2.7027027027027026,0.6756756756756757,2.027027027027027,2.2522522522522523
E00023159,213,206,4,3,1,3,2,1,0,96.71361502347418,1.8779342723004695,1.4084507042253522,0.4694835680751174,1.4084507042253522,0.9389671361502347,0.4694835680751174,0
E00023160,328,306,11,8,3,5,2,3,6,93.29268292682927,3.353658536585366,2.4390243902439024,0.9146341463414633,1.524390243902439,0.6097560975609756,0.9146341463414633,1.8292682926829267
E00023161,314,300,6,3,3,5,2,3,3,95.54140127388536,1.910828025477707,0.9554140127388535,0.9554140127388535,1.5923566878980893,0.6369426751592357,0.9554140127388535,0.9554140127388535
E00023162,367,353,8,7,1,4,0,4,2,96.18528610354224,2.17983651226158,1.9073569482288828,0.2724795640326975,1.08991825613079,0,1.08991825613079,0.544959128065395
E00023163,252,238,6,6,0,5,4,1,3,94.44444444444444,2.380952380952381,2.380952380952381,0,1.984126984126984,1.5873015873015872,0.3968253968253968,1.1904761904761905
E00023164,306,295,6,4,2,1,0,1,4,96.40522875816994,1.9607843137254901,1.3071895424836601,0.6535947712418301,0.32679738562091504,0,0.32679738562091504,1.3071895424836601
E00023165,275,268,4,4,0,3,2,1,0,97.45454545454545,1.4545454545454546,1.4545454545454546,0,1.090909090909091,0.7272727272727273,0.36363636363636365,0
E00023166,301,286,11,10,1,2,2,0,2,95.01661129568106,3.6544850498338874,3.322259136212625,0.33222591362126247,0.6644518272425249,0.6644518272425249,0,0.6644518272425249
E00023167,278,261,14,12,2,0,0,0,3,93.88489208633094,5.0359712230215825,4.316546762589928,0.7194244604316548,0,0,0,1.079136690647482
E00023168,210,201,4,4,0,3,3,0,2,95.71428571428572,1.9047619047619049,1.9047619047619049,0,1.4285714285714286,1.4285714285714286,0,0.9523809523809524
E00023169,293,279,9,9,0,2,1,1,3,95.22184300341297,3.0716723549488054,3.0716723549488054,0,0.6825938566552902,0.3412969283276451,0.3412969283276451,1.023890784982935
E00023170,402,392,7,4,3,1,1,0,2,97.51243781094527,1.7412935323383085,0.9950248756218906,0.7462686567164178,0.24875621890547264,0.24875621890547264,0,0.4975124378109453
E00023171,380,351,11,7,4,9,4,5,9,92.36842105263158,2.8947368421052633,1.8421052631578945,1.0526315789473684,2.368421052631579,1.0526315789473684,1.3157894736842104,2.368421052631579
E00023172,241,229,6,5,1,6,1,5,0,95.0207468879668,2.4896265560165975,2.0746887966804977,0.4149377593360996,2.4896265560165975,0.4149377593360996,2.0746887966804977,0
E00023173,334,317,12,10,2,1,1,0,4,94.91017964071857,3.592814371257485,2.9940119760479043,0.5988023952095809,0.29940119760479045,0.29940119760479045,0,1.1976047904191618
E00023174,295,281,7,4,3,5,4,1,2,95.25423728813558,2.3728813559322033,1.3559322033898304,1.0169491525423728,1.694915254237288,1.3559322033898304,0.3389830508474576,0.6779661016949152
E00023175,263,228,14,9,5,12,8,4,9,86.69201520912547,5.323193916349809,3.4220532319391634,1.9011406844106464,4.562737642585551,3.041825095057034,1.520912547528517,3.4220532319391634
E00023176,224,211,13,11,2,0,0,0,0,94.19642857142857,5.803571428571429,4.910714285714286,0.8928571428571428,0,0,0,0
E00023177,290,273,10,9,1,3,2,1,4,94.13793103448276,3.4482758620689653,3.103448275862069,0.3448275862068966,1.0344827586206897,0.6896551724137931,0.3448275862068966,1.3793103448275863
E00023178,321,304,8,8,0,1,0,1,8,94.70404984423676,2.4922118380062304,2.4922118380062304,0,0.3115264797507788,0,0.3115264797507788,2.4922118380062304
E00023179,286,271,8,4,4,2,1,1,5,94.75524475524476,2.797202797202797,1.3986013986013985,1.3986013986013985,0.6993006993006993,0.34965034965034963,0.34965034965034963,1.7482517482517483
E00023180,263,248,10,6,4,3,1,2,2,94.29657794676805,3.802281368821293,2.2813688212927756,1.520912547528517,1.1406844106463878,0.38022813688212925,0.7604562737642585,0.7604562737642585
E00023181,265,253,7,7,0,1,1,0,4,95.47169811320755,2.6415094339622645,2.6415094339622645,0,0.37735849056603776,0.37735849056603776,0,1.509433962264151
E00023183,287,277,9,8,1,1,0,1,0,96.51567944250871,3.1358885017421603,2.7874564459930316,0.34843205574912894,0.34843205574912894,0,0.34843205574912894,0
E00023184,333,313,13,8,5,4,4,0,3,93.993993993994,3.903903903903904,2.4024024024024024,1.5015015015015014,1.2012012012012012,1.2012012012012012,0,0.9009009009009009
E00023185,250,235,4,4,0,4,1,3,7,94,1.6,1.6,0,1.6,0.4,1.2,2.8000000000000003
E00023186,219,207,6,5,1,5,4,1,1,94.52054794520548,2.73972602739726,2.28310502283105,0.45662100456621,2.28310502283105,1.82648401826484,0.45662100456621,0.45662100456621
E00023187,313,297,8,6,2,2,2,0,6,94.88817891373802,2.5559105431309903,1.9169329073482428,0.6389776357827476,0.6389776357827476,0.6389776357827476,0,1.9169329073482428
E00023188,308,291,12,12,0,1,0,1,4,94.48051948051948,3.896103896103896,3.896103896103896,0,0.3246753246753247,0,0.3246753246753247,1.2987012987012987
E00023189,343,333,9,9,0,1,0,1,0,97.08454810495627,2.623906705539359,2.623906705539359,0,0.2915451895043732,0,0.2915451895043732,0
E00023190,297,278,11,9,2,2,0,2,6,93.60269360269359,3.7037037037037033,3.0303030303030303,0.6734006734006733,0.6734006734006733,0,0.6734006734006733,2.0202020202020203
E00023191,330,307,18,18,0,3,1,2,2,93.03030303030303,5.454545454545454,5.454545454545454,0,0.9090909090909091,0.30303030303030304,0.6060606060606061,0.6060606060606061
E00023192,241,227,9,8,1,2,1,1,3,94.1908713692946,3.7344398340248963,3.319502074688797,0.4149377593360996,0.8298755186721992,0.4149377593360996,0.4149377593360996,1.2448132780082988
E00023193,271,257,10,9,1,3,0,3,1,94.8339483394834,3.6900369003690034,3.3210332103321036,0.36900369003690037,1.107011070110701,0,1.107011070110701,0.36900369003690037
E00023196,319,310,8,6,2,0,0,0,1,97.17868338557993,2.507836990595611,1.8808777429467085,0.6269592476489028,0,0,0,0.3134796238244514
E00023197,273,260,10,6,4,2,0,2,1,95.23809523809523,3.6630036630036633,2.197802197802198,1.465201465201465,0.7326007326007326,0,0.7326007326007326,0.3663003663003663
E00023198,315,300,12,11,1,1,1,0,2,95.23809523809523,3.8095238095238098,3.492063492063492,0.31746031746031744,0.31746031746031744,0.31746031746031744,0,0.6349206349206349
E00023199,256,242,13,10,3,0,0,0,1,94.53125,5.078125,3.90625,1.171875,0,0,0,0.390625
E00023200,253,233,15,14,1,4,1,3,1,92.09486166007905,5.928853754940711,5.533596837944664,0.3952569169960474,1.5810276679841897,0.3952569169960474,1.185770750988142,0.3952569169960474
E00023201,353,333,15,11,4,3,2,1,2,94.3342776203966,4.2492917847025495,3.1161473087818696,1.13314447592068,0.84985835694051,0.56657223796034,0.28328611898017,0.56657223796034
E00023202,350,332,14,11,3,3,1,2,1,94.85714285714286,4,3.1428571428571432,0.8571428571428572,0.8571428571428572,0.2857142857142857,0.5714285714285714,0.2857142857142857
E00023203,305,282,15,9,6,1,1,0,7,92.45901639344262,4.918032786885246,2.9508196721311477,1.9672131147540985,0.32786885245901637,0.32786885245901637,0,2.2950819672131146
E00023204,353,330,14,12,2,4,1,3,5,93.48441926345609,3.9660056657223794,3.39943342776204,0.56657223796034,1.13314447592068,0.28328611898017,0.84985835694051,1.41643059490085
E00023205,290,280,10,9,1,0,0,0,0,96.55172413793103,3.4482758620689653,3.103448275862069,0.3448275862068966,0,0,0,0
E00023206,375,346,15,13,2,11,0,11,3,92.26666666666667,4,3.4666666666666663,0.5333333333333333,2.933333333333333,0,2.933333333333333,0.8
E00023207,395,378,10,9,1,4,2,2,3,95.69620253164557,2.5316455696202533,2.278481012658228,0.25316455696202533,1.0126582278481013,0.5063291139240507,0.5063291139240507,0.7594936708860759
E00023208,349,340,7,5,2,2,1,1,0,97.42120343839542,2.005730659025788,1.4326647564469914,0.5730659025787965,0.5730659025787965,0.28653295128939826,0.28653295128939826,0
E00023209,279,256,10,7,3,4,1,3,9,91.75627240143369,3.584229390681003,2.5089605734767026,1.0752688172043012,1.4336917562724014,0.35842293906810035,1.0752688172043012,3.225806451612903
E00023210,223,208,11,8,3,0,0,0,4,93.27354260089686,4.932735426008969,3.587443946188341,1.345291479820628,0,0,0,1.7937219730941705
E00023211,270,251,11,9,2,2,0,2,6,92.96296296296296,4.074074074074074,3.3333333333333335,0.7407407407407408,0.7407407407407408,0,0.7407407407407408,2.2222222222222223
E00023212,250,245,2,2,0,2,2,0,1,98,0.8,0.8,0,0.8,0.8,0,0.4
E00023213,329,307,17,15,2,1,1,0,4,93.3130699088146,5.167173252279635,4.5592705167173255,0.60790273556231,0.303951367781155,0.303951367781155,0,1.21580547112462
E00023214,223,215,8,6,2,0,0,0,0,96.41255605381166,3.587443946188341,2.690582959641256,0.8968609865470852,0,0,0,0
E00023215,284,276,7,6,1,1,0,1,0,97.1830985915493,2.464788732394366,2.112676056338028,0.35211267605633806,0.35211267605633806,0,0.35211267605633806,0
E00023216,312,291,13,10,3,2,2,0,6,93.26923076923077,4.166666666666666,3.205128205128205,0.9615384615384616,0.641025641025641,0.641025641025641,0,1.9230769230769231
E00023217,240,231,7,5,2,0,0,0,2,96.25,2.9166666666666665,2.083333333333333,0.8333333333333334,0,0,0,0.8333333333333334
E00023218,238,223,8,6,2,1,1,0,6,93.69747899159664,3.361344537815126,2.5210084033613445,0.8403361344537815,0.42016806722689076,0.42016806722689076,0,2.5210084033613445
E00023219,278,259,14,11,3,2,1,1,3,93.16546762589928,5.0359712230215825,3.9568345323741005,1.079136690647482,0.7194244604316548,0.3597122302158274,0.3597122302158274,1.079136690647482
E00023220,283,263,18,14,4,0,0,0,2,92.93286219081273,6.36042402826855,4.946996466431095,1.4134275618374559,0,0,0,0.7067137809187279
E00023221,281,264,9,8,1,5,2,3,3,93.95017793594306,3.202846975088968,2.8469750889679712,0.3558718861209964,1.7793594306049825,0.7117437722419928,1.0676156583629894,1.0676156583629894
E00023222,283,275,4,3,1,3,3,0,1,97.1731448763251,1.4134275618374559,1.0600706713780919,0.35335689045936397,1.0600706713780919,1.0600706713780919,0,0.35335689045936397
E00023223,259,241,12,11,1,2,1,1,4,93.05019305019306,4.633204633204633,4.247104247104247,0.3861003861003861,0.7722007722007722,0.3861003861003861,0.3861003861003861,1.5444015444015444
E00023224,282,267,7,5,2,2,2,0,6,94.68085106382979,2.4822695035460995,1.773049645390071,0.7092198581560284,0.7092198581560284,0.7092198581560284,0,2.127659574468085
E00023225,252,236,9,6,3,4,2,2,3,93.65079365079364,3.571428571428571,2.380952380952381,1.1904761904761905,1.5873015873015872,0.7936507936507936,0.7936507936507936,1.1904761904761905
E00023226,200,188,7,6,1,3,1,2,2,94,3.5000000000000004,3,0.5,1.5,0.5,1,1
E00023227,268,250,17,11,6,1,1,0,0,93.28358208955224,6.343283582089552,4.104477611940299,2.2388059701492535,0.3731343283582089,0.3731343283582089,0,0
E00023228,278,268,10,8,2,0,0,0,0,96.40287769784173,3.5971223021582732,2.877697841726619,0.7194244604316548,0,0,0,0
E00023229,277,260,14,11,3,1,0,1,2,93.86281588447653,5.054151624548736,3.9711191335740073,1.083032490974729,0.36101083032490977,0,0.36101083032490977,0.7220216606498195
E00023231,227,218,7,7,0,0,0,0,2,96.0352422907489,3.0837004405286343,3.0837004405286343,0,0,0,0,0.881057268722467
E00023232,358,327,23,16,7,4,4,0,4,91.34078212290503,6.424581005586592,4.4692737430167595,1.9553072625698324,1.1173184357541899,1.1173184357541899,0,1.1173184357541899
E00023233,244,224,10,8,2,3,3,0,7,91.80327868852459,4.098360655737705,3.278688524590164,0.819672131147541,1.2295081967213115,1.2295081967213115,0,2.8688524590163933
E00023234,274,255,12,5,7,2,2,0,5,93.06569343065694,4.37956204379562,1.824817518248175,2.5547445255474455,0.7299270072992701,0.7299270072992701,0,1.824817518248175
E00023235,296,266,13,11,2,8,4,4,9,89.86486486486487,4.391891891891892,3.7162162162162162,0.6756756756756757,2.7027027027027026,1.3513513513513513,1.3513513513513513,3.040540540540541
E00023236,372,335,13,10,3,12,7,5,12,90.05376344086021,3.494623655913978,2.6881720430107525,0.8064516129032258,3.225806451612903,1.881720430107527,1.3440860215053763,3.225806451612903
E00023237,372,354,9,5,4,3,1,2,6,95.16129032258065,2.4193548387096775,1.3440860215053763,1.0752688172043012,0.8064516129032258,0.2688172043010753,0.5376344086021506,1.6129032258064515
E00023238,427,413,8,2,6,2,0,2,4,96.72131147540983,1.873536299765808,0.468384074941452,1.405152224824356,0.468384074941452,0,0.468384074941452,0.936768149882904
E00023239,385,359,13,10,3,9,3,6,4,93.24675324675324,3.3766233766233764,2.5974025974025974,0.7792207792207793,2.3376623376623376,0.7792207792207793,1.5584415584415585,1.0389610389610389
E00023240,469,443,19,10,9,1,1,0,6,94.45628997867804,4.051172707889126,2.1321961620469083,1.9189765458422177,0.21321961620469082,0.21321961620469082,0,1.279317697228145
E00023241,234,221,7,6,1,2,1,1,4,94.44444444444444,2.9914529914529915,2.564102564102564,0.4273504273504274,0.8547008547008548,0.4273504273504274,0.4273504273504274,1.7094017094017095
E00023242,446,432,8,8,0,2,1,1,4,96.8609865470852,1.7937219730941705,1.7937219730941705,0,0.4484304932735426,0.2242152466367713,0.2242152466367713,0.8968609865470852
E00023243,320,301,8,7,1,5,1,4,6,94.0625,2.5,2.1875,0.3125,1.5625,0.3125,1.25,1.875
E00023244,418,395,10,8,2,6,5,1,7,94.49760765550239,2.3923444976076556,1.9138755980861244,0.4784688995215311,1.4354066985645932,1.1961722488038278,0.23923444976076555,1.674641148325359
E00023245,370,348,11,7,4,4,1,3,7,94.05405405405406,2.9729729729729732,1.891891891891892,1.0810810810810811,1.0810810810810811,0.2702702702702703,0.8108108108108109,1.891891891891892
E00023246,254,229,9,5,4,9,1,8,7,90.15748031496062,3.543307086614173,1.968503937007874,1.574803149606299,3.543307086614173,0.39370078740157477,3.149606299212598,2.7559055118110236
E00023247,382,368,11,10,1,2,2,0,1,96.33507853403141,2.8795811518324608,2.6178010471204187,0.2617801047120419,0.5235602094240838,0.5235602094240838,0,0.2617801047120419
E00023248,322,298,9,5,4,7,2,5,8,92.54658385093167,2.7950310559006213,1.5527950310559007,1.2422360248447204,2.1739130434782608,0.6211180124223602,1.5527950310559007,2.484472049689441
E00023249,376,351,13,10,3,8,3,5,4,93.35106382978722,3.4574468085106385,2.6595744680851063,0.7978723404255319,2.127659574468085,0.7978723404255319,1.3297872340425532,1.0638297872340425
E00023250,316,291,12,8,4,8,6,2,5,92.08860759493672,3.79746835443038,2.5316455696202533,1.2658227848101267,2.5316455696202533,1.89873417721519,0.6329113924050633,1.5822784810126582
E00023251,311,276,15,12,3,11,6,5,9,88.7459807073955,4.823151125401929,3.858520900321544,0.964630225080386,3.536977491961415,1.929260450160772,1.607717041800643,2.8938906752411575
E00023252,428,409,6,4,2,4,1,3,9,95.56074766355141,1.4018691588785046,0.9345794392523363,0.46728971962616817,0.9345794392523363,0.23364485981308408,0.7009345794392523,2.102803738317757
E00023253,321,305,6,4,2,4,3,1,6,95.01557632398755,1.8691588785046727,1.2461059190031152,0.6230529595015576,1.2461059190031152,0.9345794392523363,0.3115264797507788,1.8691588785046727
E00023254,368,358,8,6,2,0,0,0,2,97.28260869565217,2.1739130434782608,1.6304347826086956,0.5434782608695652,0,0,0,0.5434782608695652
E00023255,309,295,13,13,0,1,0,1,0,95.46925566343042,4.207119741100324,4.207119741100324,0,0.3236245954692557,0,0.3236245954692557,0
E00023256,386,363,13,10,3,6,5,1,4,94.04145077720207,3.3678756476683938,2.5906735751295336,0.7772020725388601,1.5544041450777202,1.2953367875647668,0.2590673575129534,1.0362694300518136
E00023257,363,327,16,15,1,9,4,5,11,90.08264462809917,4.40771349862259,4.132231404958678,0.27548209366391185,2.479338842975207,1.1019283746556474,1.3774104683195594,3.0303030303030303
E00023258,359,336,10,8,2,3,2,1,10,93.59331476323119,2.785515320334262,2.2284122562674096,0.5571030640668524,0.8356545961002786,0.5571030640668524,0.2785515320334262,2.785515320334262
E00023259,250,238,2,1,1,3,2,1,7,95.19999999999999,0.8,0.4,0.4,1.2,0.8,0.4,2.8000000000000003
E00023260,438,414,13,12,1,4,2,2,7,94.52054794520548,2.968036529680365,2.73972602739726,0.228310502283105,0.91324200913242,0.45662100456621,0.45662100456621,1.5981735159817352
E00023261,404,369,20,12,8,9,3,6,6,91.33663366336634,4.9504950495049505,2.9702970297029703,1.9801980198019802,2.2277227722772275,0.7425742574257426,1.4851485148514851,1.4851485148514851
E00023262,392,374,6,4,2,6,2,4,6,95.40816326530613,1.530612244897959,1.0204081632653061,0.5102040816326531,1.530612244897959,0.5102040816326531,1.0204081632653061,1.530612244897959
E00023263,385,370,5,4,1,6,5,1,4,96.1038961038961,1.2987012987012987,1.0389610389610389,0.2597402597402597,1.5584415584415585,1.2987012987012987,0.2597402597402597,1.0389610389610389
E00023264,402,368,9,5,4,12,4,8,13,91.54228855721394,2.2388059701492535,1.2437810945273633,0.9950248756218906,2.9850746268656714,0.9950248756218906,1.9900497512437811,3.233830845771144
E00023265,292,276,8,5,3,4,1,3,4,94.52054794520548,2.73972602739726,1.7123287671232876,1.0273972602739725,1.36986301369863,0.3424657534246575,1.0273972602739725,1.36986301369863
E00023266,218,203,8,6,2,4,2,2,3,93.11926605504587,3.669724770642202,2.7522935779816518,0.9174311926605505,1.834862385321101,0.9174311926605505,0.9174311926605505,1.3761467889908259
E00023267,346,320,13,10,3,8,2,6,5,92.48554913294798,3.7572254335260116,2.8901734104046244,0.8670520231213872,2.312138728323699,0.5780346820809248,1.7341040462427744,1.4450867052023122
E00023268,262,240,9,5,4,6,2,4,7,91.6030534351145,3.435114503816794,1.9083969465648856,1.5267175572519083,2.2900763358778624,0.7633587786259541,1.5267175572519083,2.6717557251908395
E00023269,510,466,22,15,7,9,6,3,13,91.37254901960785,4.313725490196078,2.941176470588235,1.3725490196078431,1.7647058823529411,1.1764705882352942,0.5882352941176471,2.549019607843137
E00023270,526,497,13,7,6,9,3,6,7,94.48669201520913,2.4714828897338403,1.3307984790874523,1.1406844106463878,1.7110266159695817,0.5703422053231939,1.1406844106463878,1.3307984790874523
E00023271,251,224,14,11,3,6,1,5,7,89.2430278884462,5.577689243027888,4.382470119521913,1.1952191235059761,2.3904382470119523,0.398406374501992,1.9920318725099602,2.788844621513944
E00023272,328,312,8,6,2,5,1,4,3,95.1219512195122,2.4390243902439024,1.8292682926829267,0.6097560975609756,1.524390243902439,0.3048780487804878,1.2195121951219512,0.9146341463414633
E00023273,290,265,11,7,4,8,6,2,6,91.37931034482759,3.793103448275862,2.413793103448276,1.3793103448275863,2.7586206896551726,2.0689655172413794,0.6896551724137931,2.0689655172413794
E00023274,262,240,14,10,4,4,2,2,4,91.6030534351145,5.343511450381679,3.816793893129771,1.5267175572519083,1.5267175572519083,0.7633587786259541,0.7633587786259541,1.5267175572519083
E00023275,298,289,7,6,1,1,0,1,1,96.97986577181209,2.348993288590604,2.013422818791946,0.33557046979865773,0.33557046979865773,0,0.33557046979865773,0.33557046979865773
E00023276,264,248,10,6,4,3,0,3,3,93.93939393939394,3.787878787878788,2.272727272727273,1.5151515151515151,1.1363636363636365,0,1.1363636363636365,1.1363636363636365
E00023277,279,262,14,11,3,1,0,1,2,93.9068100358423,5.017921146953405,3.942652329749104,1.0752688172043012,0.35842293906810035,0,0.35842293906810035,0.7168458781362007
E00023278,289,277,6,4,2,0,0,0,6,95.8477508650519,2.0761245674740483,1.384083044982699,0.6920415224913495,0,0,0,2.0761245674740483
E00023279,326,310,8,6,2,2,1,1,6,95.0920245398773,2.4539877300613497,1.8404907975460123,0.6134969325153374,0.6134969325153374,0.3067484662576687,0.3067484662576687,1.8404907975460123
E00023280,309,288,16,12,4,2,2,0,3,93.20388349514563,5.177993527508091,3.8834951456310676,1.2944983818770228,0.6472491909385114,0.6472491909385114,0,0.9708737864077669
E00023281,334,322,4,4,0,1,0,1,7,96.40718562874252,1.1976047904191618,1.1976047904191618,0,0.29940119760479045,0,0.29940119760479045,2.095808383233533
E00023282,286,273,7,6,1,1,0,1,5,95.45454545454545,2.4475524475524475,2.097902097902098,0.34965034965034963,0.34965034965034963,0,0.34965034965034963,1.7482517482517483
E00023283,346,331,8,5,3,2,1,1,5,95.66473988439307,2.312138728323699,1.4450867052023122,0.8670520231213872,0.5780346820809248,0.2890173410404624,0.2890173410404624,1.4450867052023122
E00023284,253,243,3,2,1,4,2,2,3,96.04743083003953,1.185770750988142,0.7905138339920948,0.3952569169960474,1.5810276679841897,0.7905138339920948,0.7905138339920948,1.185770750988142
E00023285,234,227,5,5,0,1,1,0,1,97.00854700854701,2.1367521367521367,2.1367521367521367,0,0.4273504273504274,0.4273504273504274,0,0.4273504273504274
E00023286,378,353,18,15,3,3,2,1,4,93.38624338624338,4.761904761904762,3.968253968253968,0.7936507936507936,0.7936507936507936,0.5291005291005291,0.26455026455026454,1.0582010582010581
E00023287,282,263,11,9,2,2,1,1,6,93.26241134751773,3.900709219858156,3.1914893617021276,0.7092198581560284,0.7092198581560284,0.3546099290780142,0.3546099290780142,2.127659574468085
E00023288,381,358,17,12,5,2,1,1,4,93.96325459317585,4.4619422572178475,3.149606299212598,1.3123359580052494,0.5249343832020997,0.26246719160104987,0.26246719160104987,1.0498687664041995
E00023290,330,301,19,13,6,4,3,1,6,91.21212121212122,5.757575757575758,3.939393939393939,1.8181818181818181,1.2121212121212122,0.9090909090909091,0.30303030303030304,1.8181818181818181
E00023291,409,388,11,8,3,6,3,3,4,94.86552567237165,2.689486552567237,1.9559902200488997,0.7334963325183375,1.466992665036675,0.7334963325183375,0.7334963325183375,0.9779951100244498
E00023292,282,263,10,7,3,5,4,1,4,93.26241134751773,3.546099290780142,2.4822695035460995,1.0638297872340425,1.773049645390071,1.4184397163120568,0.3546099290780142,1.4184397163120568
E00023293,326,298,22,20,2,1,1,0,5,91.41104294478528,6.748466257668712,6.134969325153374,0.6134969325153374,0.3067484662576687,0.3067484662576687,0,1.5337423312883436
E00023294,315,295,13,10,3,4,3,1,3,93.65079365079364,4.1269841269841265,3.1746031746031744,0.9523809523809524,1.2698412698412698,0.9523809523809524,0.31746031746031744,0.9523809523809524
E00023295,314,296,13,10,3,3,1,2,2,94.26751592356688,4.140127388535031,3.1847133757961785,0.9554140127388535,0.9554140127388535,0.3184713375796179,0.6369426751592357,0.6369426751592357
E00023296,318,299,10,8,2,3,2,1,6,94.0251572327044,3.1446540880503147,2.515723270440252,0.628930817610063,0.9433962264150944,0.628930817610063,0.3144654088050315,1.8867924528301887
E00023297,312,292,13,11,2,2,0,2,5,93.58974358974359,4.166666666666666,3.5256410256410255,0.641025641025641,0.641025641025641,0,0.641025641025641,1.6025641025641024
E00023298,296,266,14,10,4,10,5,5,6,89.86486486486487,4.72972972972973,3.3783783783783785,1.3513513513513513,3.3783783783783785,1.6891891891891893,1.6891891891891893,2.027027027027027
E00023299,301,283,11,9,2,0,0,0,7,94.01993355481729,3.6544850498338874,2.990033222591362,0.6644518272425249,0,0,0,2.3255813953488373
E00023300,270,249,11,7,4,7,2,5,3,92.22222222222223,4.074074074074074,2.5925925925925926,1.4814814814814816,2.5925925925925926,0.7407407407407408,1.8518518518518516,1.1111111111111112
E00023301,294,268,15,10,5,3,1,2,8,91.15646258503402,5.1020408163265305,3.4013605442176873,1.7006802721088436,1.0204081632653061,0.3401360544217687,0.6802721088435374,2.7210884353741496
E00023302,379,354,17,13,4,2,0,2,6,93.40369393139841,4.485488126649076,3.430079155672823,1.0554089709762533,0.5277044854881267,0,0.5277044854881267,1.58311345646438
E00023303,246,238,3,3,0,2,0,2,3,96.7479674796748,1.2195121951219512,1.2195121951219512,0,0.8130081300813009,0,0.8130081300813009,1.2195121951219512
E00023304,486,466,10,8,2,2,1,1,8,95.88477366255144,2.05761316872428,1.646090534979424,0.411522633744856,0.411522633744856,0.205761316872428,0.205761316872428,1.646090534979424
E00023305,327,311,11,7,4,1,1,0,4,95.10703363914374,3.3639143730886847,2.1406727828746175,1.2232415902140672,0.3058103975535168,0.3058103975535168,0,1.2232415902140672
E00023306,272,254,15,7,8,2,0,2,1,93.38235294117648,5.514705882352941,2.5735294117647056,2.941176470588235,0.7352941176470588,0,0.7352941176470588,0.3676470588235294
E00023307,319,298,9,8,1,9,4,5,3,93.41692789968651,2.8213166144200628,2.507836990595611,0.3134796238244514,2.8213166144200628,1.2539184952978055,1.5673981191222568,0.9404388714733543
E00023308,287,279,5,5,0,1,0,1,2,97.21254355400697,1.7421602787456445,1.7421602787456445,0,0.34843205574912894,0,0.34843205574912894,0.6968641114982579
E00023309,309,292,11,10,1,4,3,1,2,94.49838187702265,3.559870550161812,3.2362459546925564,0.3236245954692557,1.2944983818770228,0.9708737864077669,0.3236245954692557,0.6472491909385114
E00023310,298,280,8,8,0,4,1,3,6,93.95973154362416,2.684563758389262,2.684563758389262,0,1.342281879194631,0.33557046979865773,1.006711409395973,2.013422818791946
E00023311,269,252,14,11,3,1,0,1,2,93.68029739776952,5.204460966542751,4.089219330855019,1.1152416356877324,0.37174721189591076,0,0.37174721189591076,0.7434944237918215
E00023312,206,193,6,4,2,6,1,5,1,93.68932038834951,2.912621359223301,1.9417475728155338,0.9708737864077669,2.912621359223301,0.48543689320388345,2.4271844660194173,0.48543689320388345
E00023313,226,202,16,11,5,4,3,1,4,89.38053097345133,7.079646017699115,4.867256637168142,2.2123893805309733,1.7699115044247788,1.3274336283185841,0.4424778761061947,1.7699115044247788
E00023314,289,271,11,7,4,2,0,2,5,93.77162629757785,3.8062283737024223,2.422145328719723,1.384083044982699,0.6920415224913495,0,0.6920415224913495,1.7301038062283738
E00023315,227,212,8,5,3,5,3,2,2,93.3920704845815,3.524229074889868,2.2026431718061676,1.3215859030837005,2.2026431718061676,1.3215859030837005,0.881057268722467,0.881057268722467
E00023316,277,271,4,4,0,1,0,1,1,97.83393501805054,1.444043321299639,1.444043321299639,0,0.36101083032490977,0,0.36101083032490977,0.36101083032490977
E00023317,221,213,1,0,1,4,2,2,3,96.38009049773756,0.4524886877828055,0,0.4524886877828055,1.809954751131222,0.904977375565611,0.904977375565611,1.3574660633484164
E00023318,288,278,4,4,0,2,1,1,4,96.52777777777779,1.3888888888888888,1.3888888888888888,0,0.6944444444444444,0.3472222222222222,0.3472222222222222,1.3888888888888888
E00023319,342,327,9,7,2,2,0,2,4,95.6140350877193,2.631578947368421,2.046783625730994,0.5847953216374269,0.5847953216374269,0,0.5847953216374269,1.1695906432748537
E00023320,275,252,10,8,2,7,4,3,6,91.63636363636364,3.6363636363636362,2.909090909090909,0.7272727272727273,2.5454545454545454,1.4545454545454546,1.090909090909091,2.181818181818182
E00023321,221,213,5,5,0,3,3,0,0,96.38009049773756,2.262443438914027,2.262443438914027,0,1.3574660633484164,1.3574660633484164,0,0
E00023322,267,249,8,5,3,2,0,2,8,93.25842696629213,2.9962546816479403,1.8726591760299627,1.1235955056179776,0.7490636704119851,0,0.7490636704119851,2.9962546816479403
E00023323,278,263,9,5,4,2,2,0,4,94.60431654676259,3.237410071942446,1.7985611510791366,1.4388489208633095,0.7194244604316548,0.7194244604316548,0,1.4388489208633095
E00023324,561,518,14,9,5,15,5,10,14,92.33511586452762,2.4955436720142603,1.6042780748663104,0.8912655971479502,2.6737967914438503,0.8912655971479502,1.7825311942959003,2.4955436720142603
E00023325,306,287,12,8,4,1,1,0,6,93.79084967320262,3.9215686274509802,2.6143790849673203,1.3071895424836601,0.32679738562091504,0.32679738562091504,0,1.9607843137254901
E00023326,238,228,7,4,3,3,2,1,0,95.7983193277311,2.941176470588235,1.680672268907563,1.2605042016806722,1.2605042016806722,0.8403361344537815,0.42016806722689076,0
E00023327,270,254,11,9,2,3,2,1,2,94.07407407407408,4.074074074074074,3.3333333333333335,0.7407407407407408,1.1111111111111112,0.7407407407407408,0.3703703703703704,0.7407407407407408
E00023328,241,229,3,3,0,7,6,1,2,95.0207468879668,1.2448132780082988,1.2448132780082988,0,2.904564315352697,2.4896265560165975,0.4149377593360996,0.8298755186721992
E00023329,296,285,8,8,0,0,0,0,3,96.28378378378379,2.7027027027027026,2.7027027027027026,0,0,0,0,1.0135135135135136
E00023330,279,264,2,2,0,5,1,4,8,94.6236559139785,0.7168458781362007,0.7168458781362007,0,1.7921146953405016,0.35842293906810035,1.4336917562724014,2.867383512544803
E00023331,313,286,17,8,9,4,2,2,6,91.3738019169329,5.431309904153355,2.5559105431309903,2.8753993610223643,1.2779552715654952,0.6389776357827476,0.6389776357827476,1.9169329073482428
E00023332,335,316,5,3,2,9,6,3,5,94.32835820895522,1.4925373134328357,0.8955223880597015,0.5970149253731344,2.6865671641791042,1.791044776119403,0.8955223880597015,1.4925373134328357
E00023333,224,210,11,9,2,1,1,0,2,93.75,4.910714285714286,4.017857142857143,0.8928571428571428,0.4464285714285714,0.4464285714285714,0,0.8928571428571428
E00023334,321,297,12,11,1,6,2,4,6,92.5233644859813,3.7383177570093453,3.4267912772585665,0.3115264797507788,1.8691588785046727,0.6230529595015576,1.2461059190031152,1.8691588785046727
E00023335,278,258,13,8,5,5,3,2,2,92.80575539568345,4.676258992805756,2.877697841726619,1.7985611510791366,1.7985611510791366,1.079136690647482,0.7194244604316548,0.7194244604316548
E00023337,417,388,11,6,5,9,1,8,9,93.04556354916068,2.6378896882494005,1.4388489208633095,1.1990407673860912,2.158273381294964,0.2398081534772182,1.9184652278177456,2.158273381294964
E00023338,387,342,26,21,5,9,5,4,10,88.37209302325581,6.718346253229974,5.426356589147287,1.2919896640826873,2.3255813953488373,1.2919896640826873,1.03359173126615,2.5839793281653747
E00023339,388,367,7,5,2,1,0,1,13,94.58762886597938,1.804123711340206,1.2886597938144329,0.5154639175257731,0.25773195876288657,0,0.25773195876288657,3.350515463917526
E00023340,289,275,6,2,4,4,2,2,4,95.15570934256056,2.0761245674740483,0.6920415224913495,1.384083044982699,1.384083044982699,0.6920415224913495,0.6920415224913495,1.384083044982699
E00023341,541,510,17,11,6,4,3,1,10,94.26987060998152,3.1423290203327174,2.033271719038817,1.1090573012939002,0.7393715341959335,0.5545286506469501,0.18484288354898337,1.8484288354898337
E00023342,313,286,10,7,3,9,0,9,8,91.3738019169329,3.1948881789137378,2.2364217252396164,0.9584664536741214,2.8753993610223643,0,2.8753993610223643,2.5559105431309903
E00023343,380,353,12,8,4,7,4,3,8,92.89473684210526,3.1578947368421053,2.1052631578947367,1.0526315789473684,1.8421052631578945,1.0526315789473684,0.7894736842105263,2.1052631578947367
E00023344,521,478,30,23,7,5,3,2,8,91.74664107485604,5.758157389635317,4.414587332053743,1.3435700575815739,0.9596928982725527,0.5758157389635317,0.3838771593090211,1.5355086372360844
E00023345,313,290,9,6,3,8,5,3,6,92.65175718849841,2.8753993610223643,1.9169329073482428,0.9584664536741214,2.5559105431309903,1.5974440894568689,0.9584664536741214,1.9169329073482428
E00023346,298,270,12,8,4,4,0,4,12,90.60402684563759,4.026845637583892,2.684563758389262,1.342281879194631,1.342281879194631,0,1.342281879194631,4.026845637583892
E00023347,274,259,5,5,0,3,1,2,7,94.52554744525547,1.824817518248175,1.824817518248175,0,1.094890510948905,0.36496350364963503,0.7299270072992701,2.5547445255474455
E00023348,340,314,10,4,6,9,7,2,7,92.3529411764706,2.941176470588235,1.1764705882352942,1.7647058823529411,2.6470588235294117,2.0588235294117645,0.5882352941176471,2.0588235294117645
E00023349,277,258,13,8,5,2,1,1,4,93.14079422382672,4.693140794223827,2.888086642599278,1.8050541516245486,0.7220216606498195,0.36101083032490977,0.36101083032490977,1.444043321299639
E00023350,425,409,9,5,4,4,1,3,3,96.23529411764706,2.1176470588235294,1.1764705882352942,0.9411764705882352,0.9411764705882352,0.2352941176470588,0.7058823529411765,0.7058823529411765
E00023351,286,271,6,6,0,7,1,6,2,94.75524475524476,2.097902097902098,2.097902097902098,0,2.4475524475524475,0.34965034965034963,2.097902097902098,0.6993006993006993
E00023352,256,238,9,5,4,5,4,1,4,92.96875,3.515625,1.953125,1.5625,1.953125,1.5625,0.390625,1.5625
E00023353,320,297,10,8,2,5,1,4,8,92.8125,3.125,2.5,0.625,1.5625,0.3125,1.25,2.5
E00023354,361,347,7,5,2,4,1,3,3,96.1218836565097,1.9390581717451523,1.3850415512465373,0.554016620498615,1.10803324099723,0.2770083102493075,0.8310249307479225,0.8310249307479225
E00023355,299,288,4,3,1,2,0,2,5,96.32107023411372,1.3377926421404682,1.0033444816053512,0.33444816053511706,0.6688963210702341,0,0.6688963210702341,1.6722408026755853
E00023356,327,313,7,3,4,4,2,2,3,95.71865443425077,2.1406727828746175,0.9174311926605505,1.2232415902140672,1.2232415902140672,0.6116207951070336,0.6116207951070336,0.9174311926605505
E00023357,324,297,7,5,2,10,7,3,10,91.66666666666666,2.1604938271604937,1.5432098765432098,0.6172839506172839,3.0864197530864197,2.1604938271604937,0.9259259259259258,3.0864197530864197
E00023358,242,228,10,9,1,3,1,2,1,94.21487603305785,4.132231404958678,3.71900826446281,0.4132231404958678,1.2396694214876034,0.4132231404958678,0.8264462809917356,0.4132231404958678
E00023359,282,269,10,8,2,3,0,3,0,95.39007092198581,3.546099290780142,2.8368794326241136,0.7092198581560284,1.0638297872340425,0,1.0638297872340425,0
E00023360,264,248,8,5,3,3,3,0,5,93.93939393939394,3.0303030303030303,1.893939393939394,1.1363636363636365,1.1363636363636365,1.1363636363636365,0,1.893939393939394
E00023361,301,287,9,8,1,2,0,2,3,95.34883720930233,2.990033222591362,2.6578073089700998,0.33222591362126247,0.6644518272425249,0,0.6644518272425249,0.9966777408637874
E00023362,284,268,11,7,4,3,3,0,2,94.36619718309859,3.873239436619718,2.464788732394366,1.4084507042253522,1.056338028169014,1.056338028169014,0,0.7042253521126761
E00023363,342,329,9,7,2,2,1,1,2,96.19883040935673,2.631578947368421,2.046783625730994,0.5847953216374269,0.5847953216374269,0.29239766081871343,0.29239766081871343,0.5847953216374269
E00023364,253,247,4,2,2,1,0,1,1,97.62845849802372,1.5810276679841897,0.7905138339920948,0.7905138339920948,0.3952569169960474,0,0.3952569169960474,0.3952569169960474
E00023365,309,284,16,13,3,4,2,2,5,91.9093851132686,5.177993527508091,4.207119741100324,0.9708737864077669,1.2944983818770228,0.6472491909385114,0.6472491909385114,1.6181229773462782
E00023366,304,281,10,7,3,5,3,2,8,92.43421052631578,3.289473684210526,2.302631578947368,0.9868421052631579,1.644736842105263,0.9868421052631579,0.6578947368421052,2.631578947368421
E00023368,267,253,11,9,2,1,0,1,2,94.7565543071161,4.119850187265917,3.3707865168539324,0.7490636704119851,0.37453183520599254,0,0.37453183520599254,0.7490636704119851
E00023369,317,283,13,9,4,7,4,3,14,89.27444794952682,4.100946372239748,2.8391167192429023,1.2618296529968454,2.2082018927444795,1.2618296529968454,0.9463722397476341,4.416403785488959
E00023370,306,279,15,11,4,3,1,2,9,91.17647058823529,4.901960784313726,3.594771241830065,1.3071895424836601,0.9803921568627451,0.32679738562091504,0.6535947712418301,2.941176470588235
E00023371,362,338,17,13,4,1,0,1,6,93.37016574585635,4.696132596685083,3.591160220994475,1.1049723756906076,0.2762430939226519,0,0.2762430939226519,1.6574585635359116
E00023372,292,259,18,12,6,6,3,3,9,88.6986301369863,6.164383561643835,4.10958904109589,2.054794520547945,2.054794520547945,1.0273972602739725,1.0273972602739725,3.0821917808219177
E00023373,281,261,13,10,3,2,1,1,5,92.88256227758008,4.6263345195729535,3.558718861209965,1.0676156583629894,0.7117437722419928,0.3558718861209964,0.3558718861209964,1.7793594306049825
E00023374,341,303,21,19,2,10,1,9,7,88.85630498533725,6.158357771260997,5.571847507331378,0.5865102639296188,2.932551319648094,0.2932551319648094,2.6392961876832843,2.0527859237536656
E00023375,286,276,8,8,0,1,0,1,1,96.5034965034965,2.797202797202797,2.797202797202797,0,0.34965034965034963,0,0.34965034965034963,0.34965034965034963
E00023376,314,282,13,9,4,8,2,6,11,89.80891719745223,4.140127388535031,2.8662420382165608,1.2738853503184715,2.547770700636943,0.6369426751592357,1.910828025477707,3.5031847133757963
E00023377,392,375,12,9,3,2,2,0,3,95.66326530612244,3.061224489795918,2.295918367346939,0.7653061224489796,0.5102040816326531,0.5102040816326531,0,0.7653061224489796
E00023378,359,332,17,14,3,3,3,0,7,92.47910863509749,4.735376044568245,3.8997214484679668,0.8356545961002786,0.8356545961002786,0.8356545961002786,0,1.9498607242339834
E00023379,272,255,6,4,2,2,1,1,9,93.75,2.2058823529411766,1.4705882352941175,0.7352941176470588,0.7352941176470588,0.3676470588235294,0.3676470588235294,3.308823529411765
E00023380,242,222,7,6,1,7,4,3,6,91.73553719008265,2.8925619834710745,2.479338842975207,0.4132231404958678,2.8925619834710745,1.6528925619834711,1.2396694214876034,2.479338842975207
E00023381,338,313,16,11,5,5,4,1,4,92.60355029585799,4.733727810650888,3.2544378698224854,1.4792899408284024,1.4792899408284024,1.183431952662722,0.2958579881656805,1.183431952662722
E00023382,289,260,14,8,6,9,2,7,6,89.96539792387543,4.844290657439446,2.768166089965398,2.0761245674740483,3.1141868512110724,0.6920415224913495,2.422145328719723,2.0761245674740483
E00023383,447,422,8,7,1,5,2,3,12,94.40715883668904,1.7897091722595078,1.5659955257270695,0.22371364653243847,1.1185682326621924,0.44742729306487694,0.6711409395973155,2.684563758389262
E00023384,263,248,10,8,2,0,0,0,5,94.29657794676805,3.802281368821293,3.041825095057034,0.7604562737642585,0,0,0,1.9011406844106464
E00023385,304,279,13,7,6,7,2,5,5,91.77631578947368,4.276315789473684,2.302631578947368,1.9736842105263157,2.302631578947368,0.6578947368421052,1.644736842105263,1.644736842105263
E00023386,272,249,12,9,3,6,5,1,5,91.54411764705883,4.411764705882353,3.308823529411765,1.1029411764705883,2.2058823529411766,1.8382352941176472,0.3676470588235294,1.8382352941176472
E00023387,453,414,12,6,6,16,9,7,11,91.3907284768212,2.6490066225165565,1.3245033112582782,1.3245033112582782,3.532008830022075,1.9867549668874174,1.545253863134658,2.4282560706401766
E00023388,364,320,16,13,3,13,10,3,15,87.91208791208791,4.395604395604396,3.571428571428571,0.8241758241758242,3.571428571428571,2.7472527472527473,0.8241758241758242,4.1208791208791204
E00023389,335,319,4,2,2,4,2,2,8,95.22388059701493,1.1940298507462688,0.5970149253731344,0.5970149253731344,1.1940298507462688,0.5970149253731344,0.5970149253731344,2.3880597014925375
E00023390,514,492,11,10,1,4,4,0,7,95.71984435797665,2.140077821011673,1.9455252918287937,0.19455252918287938,0.7782101167315175,0.7782101167315175,0,1.3618677042801557
E00023391,316,288,16,13,3,7,4,3,5,91.13924050632912,5.063291139240507,4.113924050632911,0.949367088607595,2.2151898734177213,1.2658227848101267,0.949367088607595,1.5822784810126582
E00023392,298,269,8,5,3,10,7,3,11,90.26845637583892,2.684563758389262,1.6778523489932886,1.006711409395973,3.3557046979865772,2.348993288590604,1.006711409395973,3.691275167785235
E00023393,293,269,11,3,8,6,1,5,7,91.80887372013652,3.754266211604096,1.023890784982935,2.7303754266211606,2.04778156996587,0.3412969283276451,1.7064846416382253,2.3890784982935154
E00023394,397,355,19,16,3,6,2,4,17,89.4206549118388,4.785894206549118,4.030226700251889,0.7556675062972292,1.5113350125944585,0.5037783375314862,1.0075566750629723,4.282115869017632
E00023395,163,156,6,4,2,0,0,0,1,95.70552147239265,3.6809815950920246,2.4539877300613497,1.2269938650306749,0,0,0,0.6134969325153374
E00023396,282,264,14,11,3,3,1,2,1,93.61702127659575,4.964539007092199,3.900709219858156,1.0638297872340425,1.0638297872340425,0.3546099290780142,0.7092198581560284,0.3546099290780142
E00023397,278,256,12,9,3,3,2,1,7,92.08633093525181,4.316546762589928,3.237410071942446,1.079136690647482,1.079136690647482,0.7194244604316548,0.3597122302158274,2.5179856115107913
E00023398,297,277,7,3,4,6,4,2,7,93.26599326599326,2.356902356902357,1.0101010101010102,1.3468013468013467,2.0202020202020203,1.3468013468013467,0.6734006734006733,2.356902356902357
E00023399,263,240,13,8,5,3,2,1,7,91.25475285171103,4.942965779467681,3.041825095057034,1.9011406844106464,1.1406844106463878,0.7604562737642585,0.38022813688212925,2.6615969581749046
E00023400,306,287,11,7,4,4,1,3,4,93.79084967320262,3.594771241830065,2.287581699346405,1.3071895424836601,1.3071895424836601,0.32679738562091504,0.9803921568627451,1.3071895424836601
E00023401,220,212,5,5,0,3,2,1,0,96.36363636363636,2.272727272727273,2.272727272727273,0,1.3636363636363635,0.9090909090909091,0.45454545454545453,0
E00023402,266,241,13,12,1,5,3,2,7,90.6015037593985,4.887218045112782,4.511278195488721,0.37593984962406013,1.8796992481203008,1.1278195488721803,0.7518796992481203,2.631578947368421
E00023403,276,266,6,3,3,4,0,4,0,96.37681159420289,2.1739130434782608,1.0869565217391304,1.0869565217391304,1.4492753623188406,0,1.4492753623188406,0
E00023404,294,275,12,8,4,3,0,3,4,93.5374149659864,4.081632653061225,2.7210884353741496,1.3605442176870748,1.0204081632653061,0,1.0204081632653061,1.3605442176870748
E00023405,272,255,10,6,4,3,2,1,4,93.75,3.6764705882352944,2.2058823529411766,1.4705882352941175,1.1029411764705883,0.7352941176470588,0.3676470588235294,1.4705882352941175
E00023406,332,304,17,13,4,2,1,1,9,91.56626506024097,5.120481927710843,3.91566265060241,1.2048192771084338,0.6024096385542169,0.30120481927710846,0.30120481927710846,2.710843373493976
E00023407,364,325,18,13,5,8,4,4,13,89.28571428571429,4.945054945054945,3.571428571428571,1.3736263736263736,2.197802197802198,1.098901098901099,1.098901098901099,3.571428571428571
E00023408,289,264,15,10,5,3,2,1,7,91.34948096885813,5.190311418685121,3.4602076124567476,1.7301038062283738,1.0380622837370241,0.6920415224913495,0.34602076124567477,2.422145328719723
E00023409,301,283,12,9,3,2,1,1,4,94.01993355481729,3.9867109634551494,2.990033222591362,0.9966777408637874,0.6644518272425249,0.33222591362126247,0.33222591362126247,1.3289036544850499
E00023410,268,250,12,12,0,3,2,1,3,93.28358208955224,4.477611940298507,4.477611940298507,0,1.1194029850746268,0.7462686567164178,0.3731343283582089,1.1194029850746268
E00023411,340,321,11,9,2,2,0,2,6,94.41176470588235,3.2352941176470593,2.6470588235294117,0.5882352941176471,0.5882352941176471,0,0.5882352941176471,1.7647058823529411
E00170900,321,310,7,7,0,0,0,0,4,96.57320872274143,2.1806853582554515,2.1806853582554515,0,0,0,0,1.2461059190031152
E00170901,244,233,8,5,3,2,1,1,1,95.49180327868852,3.278688524590164,2.0491803278688523,1.2295081967213115,0.819672131147541,0.4098360655737705,0.4098360655737705,0.4098360655737705
E00170902,234,223,9,6,3,0,0,0,2,95.2991452991453,3.8461538461538463,2.564102564102564,1.282051282051282,0,0,0,0.8547008547008548
E00170903,717,692,19,17,2,1,1,0,5,96.51324965132495,2.6499302649930265,2.3709902370990235,0.2789400278940028,0.1394700139470014,0.1394700139470014,0,0.697350069735007
E00170904,199,187,6,2,4,2,1,1,4,93.96984924623115,3.015075376884422,1.0050251256281406,2.0100502512562812,1.0050251256281406,0.5025125628140703,0.5025125628140703,2.0100502512562812
E00170905,241,221,10,9,1,8,5,3,2,91.70124481327801,4.149377593360995,3.7344398340248963,0.4149377593360996,3.319502074688797,2.0746887966804977,1.2448132780082988,0.8298755186721992
E00170906,383,370,8,7,1,4,2,2,1,96.60574412532638,2.088772845953003,1.8276762402088773,0.26109660574412535,1.0443864229765014,0.5221932114882507,0.5221932114882507,0.26109660574412535
E00170907,217,197,14,9,5,3,1,2,3,90.78341013824884,6.451612903225806,4.147465437788019,2.3041474654377883,1.3824884792626728,0.4608294930875576,0.9216589861751152,1.3824884792626728
E00170908,355,340,9,9,0,5,1,4,1,95.77464788732394,2.535211267605634,2.535211267605634,0,1.4084507042253522,0.28169014084507044,1.1267605633802817,0.28169014084507044
E00170909,548,513,23,17,6,4,3,1,8,93.61313868613139,4.197080291970803,3.102189781021898,1.094890510948905,0.7299270072992701,0.5474452554744526,0.18248175182481752,1.4598540145985401
E00170910,465,448,11,10,1,4,2,2,2,96.34408602150538,2.3655913978494625,2.1505376344086025,0.21505376344086022,0.8602150537634409,0.43010752688172044,0.43010752688172044,0.43010752688172044
E00170911,333,314,13,11,2,1,0,1,5,94.29429429429429,3.903903903903904,3.303303303303303,0.6006006006006006,0.3003003003003003,0,0.3003003003003003,1.5015015015015014
E00170912,249,242,5,3,2,2,1,1,0,97.18875502008032,2.0080321285140563,1.2048192771084338,0.8032128514056224,0.8032128514056224,0.4016064257028112,0.4016064257028112,0
E00170913,203,194,5,5,0,4,1,3,0,95.56650246305419,2.4630541871921183,2.4630541871921183,0,1.9704433497536946,0.49261083743842365,1.477832512315271,0
E00170914,128,119,5,4,1,3,0,3,1,92.96875,3.90625,3.125,0.78125,2.34375,0,2.34375,0.78125
E00170915,125,111,11,11,0,1,1,0,2,88.8,8.799999999999999,8.799999999999999,0,0.8,0.8,0,1.6
E00170916,227,213,8,6,2,4,1,3,2,93.83259911894272,3.524229074889868,2.643171806167401,0.881057268722467,1.762114537444934,0.4405286343612335,1.3215859030837005,0.881057268722467
E00170918,210,206,3,3,0,1,0,1,0,98.09523809523809,1.4285714285714286,1.4285714285714286,0,0.4761904761904762,0,0.4761904761904762,0
E00170920,269,248,13,11,2,3,1,2,5,92.19330855018588,4.83271375464684,4.089219330855019,0.7434944237918215,1.1152416356877324,0.37174721189591076,0.7434944237918215,1.858736059479554
E00170921,273,261,9,8,1,1,0,1,2,95.6043956043956,3.296703296703297,2.93040293040293,0.3663003663003663,0.3663003663003663,0,0.3663003663003663,0.7326007326007326
E00170923,220,212,7,7,0,1,1,0,0,96.36363636363636,3.1818181818181817,3.1818181818181817,0,0.45454545454545453,0.45454545454545453,0,0
E00170926,187,178,7,5,2,2,2,0,0,95.18716577540107,3.7433155080213902,2.6737967914438503,1.06951871657754,1.06951871657754,1.06951871657754,0,0
E00170928,130,123,3,0,3,4,0,4,0,94.61538461538461,2.307692307692308,0,2.307692307692308,3.076923076923077,0,3.076923076923077,0
E00170929,264,250,4,4,0,7,0,7,3,94.6969696969697,1.5151515151515151,1.5151515151515151,0,2.6515151515151514,0,2.6515151515151514,1.1363636363636365
E00170931,385,361,9,4,5,8,4,4,7,93.76623376623377,2.3376623376623376,1.0389610389610389,1.2987012987012987,2.0779220779220777,1.0389610389610389,1.0389610389610389,1.8181818181818181
E00170932,421,389,15,10,5,5,3,2,12,92.39904988123516,3.5629453681710213,2.375296912114014,1.187648456057007,1.187648456057007,0.7125890736342043,0.4750593824228029,2.8503562945368173
E00170934,133,124,7,5,2,1,0,1,1,93.23308270676691,5.263157894736842,3.7593984962406015,1.5037593984962405,0.7518796992481203,0,0.7518796992481203,0.7518796992481203
E00170935,355,339,7,6,1,8,3,5,1,95.49295774647887,1.971830985915493,1.6901408450704223,0.28169014084507044,2.2535211267605635,0.8450704225352111,1.4084507042253522,0.28169014084507044
E00170937,246,236,2,2,0,3,0,3,5,95.9349593495935,0.8130081300813009,0.8130081300813009,0,1.2195121951219512,0,1.2195121951219512,2.0325203252032518
E00170939,250,231,10,5,5,4,4,0,5,92.4,4,2,2,1.6,1.6,0,2
E00170940,250,235,8,6,2,5,3,2,2,94,3.2,2.4,0.8,2,1.2,0.8,0.8
E00170942,184,175,4,4,0,2,2,0,3,95.1086956521739,2.1739130434782608,2.1739130434782608,0,1.0869565217391304,1.0869565217391304,0,1.6304347826086956
E00170943,168,160,6,5,1,0,0,0,2,95.23809523809523,3.571428571428571,2.976190476190476,0.5952380952380952,0,0,0,1.1904761904761905
E00170948,255,234,8,3,5,4,0,4,9,91.76470588235294,3.1372549019607843,1.1764705882352942,1.9607843137254901,1.5686274509803921,0,1.5686274509803921,3.5294117647058822
E00170951,150,144,5,3,2,0,0,0,1,96,3.3333333333333335,2,1.3333333333333335,0,0,0,0.6666666666666667
E00170953,200,193,2,1,1,3,3,0,2,96.5,1,0.5,0.5,1.5,1.5,0,1
E00170956,257,246,4,4,0,1,0,1,6,95.71984435797665,1.556420233463035,1.556420233463035,0,0.38910505836575876,0,0.38910505836575876,2.3346303501945527
E00170957,186,170,11,7,4,1,1,0,4,91.39784946236558,5.913978494623656,3.763440860215054,2.1505376344086025,0.5376344086021506,0.5376344086021506,0,2.1505376344086025
E00170959,248,238,6,5,1,3,2,1,1,95.96774193548387,2.4193548387096775,2.0161290322580645,0.4032258064516129,1.2096774193548387,0.8064516129032258,0.4032258064516129,0.4032258064516129
E00170960,220,205,11,6,5,1,0,1,3,93.18181818181817,5,2.727272727272727,2.272727272727273,0.45454545454545453,0,0.45454545454545453,1.3636363636363635
E00170962,293,279,8,6,2,1,1,0,5,95.22184300341297,2.7303754266211606,2.04778156996587,0.6825938566552902,0.3412969283276451,0.3412969283276451,0,1.7064846416382253
E00170963,228,217,8,6,2,3,1,2,0,95.17543859649122,3.508771929824561,2.631578947368421,0.8771929824561403,1.3157894736842104,0.43859649122807015,0.8771929824561403,0
E00170965,179,172,7,6,1,0,0,0,0,96.08938547486034,3.910614525139665,3.35195530726257,0.5586592178770949,0,0,0,0
E00170967,240,231,2,2,0,3,2,1,4,96.25,0.8333333333333334,0.8333333333333334,0,1.25,0.8333333333333334,0.4166666666666667,1.6666666666666667
E00170968,157,153,2,1,1,2,1,1,0,97.45222929936305,1.2738853503184715,0.6369426751592357,0.6369426751592357,1.2738853503184715,0.6369426751592357,0.6369426751592357,0
E00170970,240,224,11,7,4,1,1,0,4,93.33333333333333,4.583333333333333,2.9166666666666665,1.6666666666666667,0.4166666666666667,0.4166666666666667,0,1.6666666666666667
E00170971,153,143,7,6,1,1,0,1,2,93.4640522875817,4.57516339869281,3.9215686274509802,0.6535947712418301,0.6535947712418301,0,0.6535947712418301,1.3071895424836601
E00171037,165,155,6,6,0,1,0,1,3,93.93939393939394,3.6363636363636362,3.6363636363636362,0,0.6060606060606061,0,0.6060606060606061,1.8181818181818181
E00171038,187,176,7,5,2,2,0,2,2,94.11764705882352,3.7433155080213902,2.6737967914438503,1.06951871657754,1.06951871657754,0,1.06951871657754,1.06951871657754
E00171040,176,163,7,6,1,5,1,4,1,92.61363636363636,3.977272727272727,3.4090909090909087,0.5681818181818182,2.840909090909091,0.5681818181818182,2.272727272727273,0.5681818181818182
E00171041,272,256,12,9,3,2,2,0,2,94.11764705882352,4.411764705882353,3.308823529411765,1.1029411764705883,0.7352941176470588,0.7352941176470588,0,0.7352941176470588
E00171043,182,170,8,6,2,0,0,0,4,93.4065934065934,4.395604395604396,3.296703296703297,1.098901098901099,0,0,0,2.197802197802198
E00171044,128,122,6,6,0,0,0,0,0,95.3125,4.6875,4.6875,0,0,0,0,0
E00171046,235,216,11,9,2,5,4,1,3,91.91489361702128,4.680851063829787,3.829787234042553,0.851063829787234,2.127659574468085,1.702127659574468,0.425531914893617,1.276595744680851
E00171049,259,249,2,2,0,3,2,1,5,96.13899613899613,0.7722007722007722,0.7722007722007722,0,1.1583011583011582,0.7722007722007722,0.3861003861003861,1.9305019305019304
E00171051,163,158,5,5,0,0,0,0,0,96.93251533742331,3.067484662576687,3.067484662576687,0,0,0,0,0
E00171055,299,289,8,7,1,2,2,0,0,96.65551839464884,2.6755852842809364,2.341137123745819,0.33444816053511706,0.6688963210702341,0.6688963210702341,0,0
E00171058,383,371,7,7,0,3,0,3,2,96.8668407310705,1.8276762402088773,1.8276762402088773,0,0.7832898172323759,0,0.7832898172323759,0.5221932114882507
E00171060,201,188,13,9,4,0,0,0,0,93.53233830845771,6.467661691542288,4.477611940298507,1.9900497512437811,0,0,0,0
E00171061,196,191,5,5,0,0,0,0,0,97.44897959183673,2.5510204081632653,2.5510204081632653,0,0,0,0,0
E00171063,284,278,4,4,0,1,0,1,1,97.88732394366197,1.4084507042253522,1.4084507042253522,0,0.35211267605633806,0,0.35211267605633806,0.35211267605633806
E00171065,288,262,19,16,3,4,4,0,3,90.97222222222221,6.597222222222222,5.555555555555555,1.0416666666666665,1.3888888888888888,1.3888888888888888,0,1.0416666666666665
E00171066,181,167,11,8,3,1,0,1,2,92.26519337016575,6.077348066298343,4.41988950276243,1.6574585635359116,0.5524861878453038,0,0.5524861878453038,1.1049723756906076
E00171068,241,233,4,3,1,1,0,1,3,96.6804979253112,1.6597510373443984,1.2448132780082988,0.4149377593360996,0.4149377593360996,0,0.4149377593360996,1.2448132780082988
E00171069,218,208,8,6,2,2,1,1,0,95.41284403669725,3.669724770642202,2.7522935779816518,0.9174311926605505,0.9174311926605505,0.45871559633027525,0.45871559633027525,0
E00171071,263,246,5,4,1,4,0,4,8,93.5361216730038,1.9011406844106464,1.520912547528517,0.38022813688212925,1.520912547528517,0,1.520912547528517,3.041825095057034
E00171072,188,178,7,7,0,3,1,2,0,94.68085106382979,3.723404255319149,3.723404255319149,0,1.5957446808510638,0.5319148936170213,1.0638297872340425,0
E00171074,226,218,6,4,2,0,0,0,2,96.46017699115043,2.6548672566371683,1.7699115044247788,0.8849557522123894,0,0,0,0.8849557522123894
E00171075,264,254,7,6,1,3,2,1,0,96.21212121212122,2.6515151515151514,2.272727272727273,0.3787878787878788,1.1363636363636365,0.7575757575757576,0.3787878787878788,0
E00171077,242,228,8,7,1,6,4,2,0,94.21487603305785,3.3057851239669422,2.8925619834710745,0.4132231404958678,2.479338842975207,1.6528925619834711,0.8264462809917356,0
E00171079,193,183,5,5,0,4,1,3,1,94.81865284974094,2.5906735751295336,2.5906735751295336,0,2.072538860103627,0.5181347150259068,1.5544041450777202,0.5181347150259068
E00171080,110,106,2,2,0,1,1,0,1,96.36363636363636,1.8181818181818181,1.8181818181818181,0,0.9090909090909091,0.9090909090909091,0,0.9090909090909091
E00171085,334,318,12,8,4,0,0,0,4,95.20958083832335,3.592814371257485,2.3952095808383236,1.1976047904191618,0,0,0,1.1976047904191618
E00171086,221,216,2,2,0,1,1,0,2,97.73755656108597,0.904977375565611,0.904977375565611,0,0.4524886877828055,0.4524886877828055,0,0.904977375565611
E00171088,208,197,7,5,2,2,1,1,2,94.71153846153845,3.3653846153846154,2.403846153846154,0.9615384615384616,0.9615384615384616,0.4807692307692308,0.4807692307692308,0.9615384615384616
E00183095,370,348,7,3,4,6,2,4,9,94.05405405405406,1.891891891891892,0.8108108108108109,1.0810810810810811,1.6216216216216217,0.5405405405405406,1.0810810810810811,2.4324324324324325
E00183096,225,208,8,5,3,5,4,1,4,92.44444444444444,3.5555555555555554,2.2222222222222223,1.3333333333333335,2.2222222222222223,1.7777777777777777,0.4444444444444444,1.7777777777777777
E00183097,326,316,2,1,1,4,1,3,4,96.93251533742331,0.6134969325153374,0.3067484662576687,0.3067484662576687,1.2269938650306749,0.3067484662576687,0.9202453987730062,1.2269938650306749
E00183102,347,336,7,7,0,2,0,2,2,96.82997118155619,2.0172910662824206,2.0172910662824206,0,0.57636887608069165,0,0.57636887608069165,0.57636887608069165
E00183104,376,357,14,12,2,1,0,1,4,94.9468085106383,3.723404255319149,3.1914893617021276,0.5319148936170213,0.26595744680851063,0,0.26595744680851063,1.0638297872340425
E00183105,433,403,13,12,1,6,5,1,11,93.0715935334873,3.0023094688221708,2.771362586605081,0.23094688221709006,1.3856812933025404,1.1547344110854503,0.23094688221709006,2.5404157043879905
E00183106,441,416,6,6,0,11,6,5,8,94.33106575963718,1.3605442176870748,1.3605442176870748,0,2.494331065759637,1.3605442176870748,1.1337868480725624,1.8140589569160999
E00183107,248,229,10,7,3,6,2,4,3,92.33870967741935,4.032258064516129,2.82258064516129,1.2096774193548387,2.4193548387096775,0.8064516129032258,1.6129032258064515,1.2096774193548387
E00183110,233,231,2,1,1,0,0,0,0,99.14163090128756,0.8583690987124464,0.4291845493562232,0.4291845493562232,0,0,0,0
E00183111,206,197,1,1,0,1,1,0,7,95.63106796116504,0.48543689320388345,0.48543689320388345,0,0.48543689320388345,0.48543689320388345,0,3.3980582524271843
E00183112,231,214,15,13,2,1,1,0,1,92.64069264069265,6.493506493506493,5.627705627705628,0.8658008658008658,0.4329004329004329,0.4329004329004329,0,0.4329004329004329
E00183114,300,292,5,0,5,2,1,1,1,97.33333333333334,1.6666666666666667,0,1.6666666666666667,0.6666666666666667,0.33333333333333337,0.33333333333333337,0.33333333333333337
E00183117,236,228,4,3,1,1,0,1,3,96.61016949152543,1.694915254237288,1.2711864406779663,0.423728813559322,0.423728813559322,0,0.423728813559322,1.2711864406779663
E00183119,187,180,5,5,0,2,2,0,0,96.2566844919786,2.6737967914438503,2.6737967914438503,0,1.06951871657754,1.06951871657754,0,0
E00183120,292,279,11,9,2,1,0,1,1,95.54794520547945,3.767123287671233,3.0821917808219177,0.684931506849315,0.3424657534246575,0,0.3424657534246575,0.3424657534246575
E00183121,166,163,1,1,0,1,0,1,1,98.19277108433735,0.6024096385542169,0.6024096385542169,0,0.6024096385542169,0,0.6024096385542169,0.6024096385542169
E00183122,143,141,0,0,0,2,0,2,0,98.6013986013986,0,0,0,1.3986013986013985,0,1.3986013986013985,0
E00183123,181,177,2,2,0,2,0,2,0,97.79005524861878,1.1049723756906076,1.1049723756906076,0,1.1049723756906076,0,1.1049723756906076,0
E00183124,256,244,5,4,1,4,0,4,3,95.3125,1.953125,1.5625,0.390625,1.5625,0,1.5625,1.171875
E00183127,151,146,2,1,1,1,1,0,2,96.68874172185431,1.3245033112582782,0.6622516556291391,0.6622516556291391,0.6622516556291391,0.6622516556291391,0,1.3245033112582782
E00183128,947,908,13,8,5,13,13,0,13,95.8817317845829,1.3727560718057021,0.8447729672650475,0.5279831045406547,1.3727560718057021,1.3727560718057021,0,1.3727560718057021
E00183129,197,190,4,4,0,3,0,3,0,96.44670050761421,2.030456852791878,2.030456852791878,0,1.5228426395939088,0,1.5228426395939088,0
E00183130,205,200,2,2,0,0,0,0,3,97.5609756097561,0.975609756097561,0.975609756097561,0,0,0,0,1.4634146341463417
E00183131,233,225,5,3,2,2,0,2,1,96.56652360515021,2.1459227467811157,1.2875536480686696,0.8583690987124464,0.8583690987124464,0,0.8583690987124464,0.4291845493562232
E00183132,406,360,18,15,3,14,6,8,14,88.66995073891626,4.433497536945813,3.6945812807881775,0.7389162561576355,3.4482758620689653,1.477832512315271,1.9704433497536946,3.4482758620689653
E00183133,227,219,7,2,5,0,0,0,1,96.47577092511013,3.0837004405286343,0.881057268722467,2.2026431718061676,0,0,0,0.4405286343612335
E00183136,232,222,5,3,2,2,0,2,3,95.6896551724138,2.1551724137931036,1.293103448275862,0.8620689655172413,0.8620689655172413,0,0.8620689655172413,1.293103448275862
E00183137,360,342,8,5,3,10,10,0,0,95,2.2222222222222223,1.3888888888888888,0.8333333333333334,2.7777777777777777,2.7777777777777777,0,0
E00183138,198,187,8,7,1,0,0,0,3,94.44444444444444,4.040404040404041,3.535353535353535,0.5050505050505051,0,0,0,1.5151515151515151
E00183141,201,195,3,3,0,0,0,0,3,97.01492537313433,1.4925373134328357,1.4925373134328357,0,0,0,0,1.4925373134328357
E00183145,166,163,3,2,1,0,0,0,0,98.19277108433735,1.8072289156626504,1.2048192771084338,0.6024096385542169,0,0,0,0
E00183146,154,151,3,2,1,0,0,0,0,98.05194805194806,1.948051948051948,1.2987012987012987,0.6493506493506493,0,0,0,0
E00183147,405,391,8,5,3,3,2,1,3,96.54320987654322,1.9753086419753085,1.2345679012345678,0.7407407407407408,0.7407407407407408,0.49382716049382713,0.24691358024691357,0.7407407407407408
E00183149,252,238,6,4,2,5,5,0,3,94.44444444444444,2.380952380952381,1.5873015873015872,0.7936507936507936,1.984126984126984,1.984126984126984,0,1.1904761904761905
E00183150,267,253,6,3,3,4,3,1,4,94.7565543071161,2.247191011235955,1.1235955056179776,1.1235955056179776,1.4981273408239701,1.1235955056179776,0.37453183520599254,1.4981273408239701
E00183153,195,188,2,2,0,2,0,2,3,96.41025641025641,1.0256410256410255,1.0256410256410255,0,1.0256410256410255,0,1.0256410256410255,1.5384615384615385
E00183154,405,364,11,6,5,15,4,11,15,89.87654320987654,2.7160493827160495,1.4814814814814816,1.2345679012345678,3.7037037037037033,0.9876543209876543,2.7160493827160495,3.7037037037037033
E00183155,223,212,4,3,1,4,2,2,3,95.06726457399103,1.7937219730941705,1.345291479820628,0.4484304932735426,1.7937219730941705,0.8968609865470852,0.8968609865470852,1.345291479820628
E00183156,273,257,7,5,2,8,0,8,1,94.13919413919413,2.564102564102564,1.8315018315018317,0.7326007326007326,2.93040293040293,0,2.93040293040293,0.3663003663003663
E00183159,165,165,0,0,0,0,0,0,0,100,0,0,0,0,0,0,0
E00183161,292,285,6,2,4,1,0,1,0,97.6027397260274,2.054794520547945,0.684931506849315,1.36986301369863,0.3424657534246575,0,0.3424657534246575,0
E00183162,267,253,9,3,6,4,3,1,1,94.7565543071161,3.3707865168539324,1.1235955056179776,2.247191011235955,1.4981273408239701,1.1235955056179776,0.37453183520599254,0.37453183520599254
E00183163,218,209,6,6,0,2,0,2,1,95.87155963302753,2.7522935779816518,2.7522935779816518,0,0.9174311926605505,0,0.9174311926605505,0.45871559633027525
E00183164,303,298,2,1,1,3,0,3,0,98.34983498349835,0.6600660066006601,0.33003300330033003,0.33003300330033003,0.9900990099009901,0,0.9900990099009901,0
E00183166,307,291,10,10,0,4,0,4,2,94.78827361563518,3.257328990228013,3.257328990228013,0,1.3029315960912053,0,1.3029315960912053,0.6514657980456027
E00183167,490,473,15,12,3,2,1,1,0,96.53061224489797,3.061224489795918,2.4489795918367347,0.6122448979591837,0.40816326530612246,0.20408163265306123,0.20408163265306123,0
E00183169,340,321,7,5,2,9,3,6,3,94.41176470588235,2.0588235294117645,1.4705882352941175,0.5882352941176471,2.6470588235294117,0.8823529411764706,1.7647058823529411,0.8823529411764706
E00183170,123,113,7,7,0,2,2,0,1,91.869918699187,5.691056910569105,5.691056910569105,0,1.6260162601626018,1.6260162601626018,0,0.8130081300813009
E00183171,216,201,4,3,1,8,2,6,3,93.05555555555556,1.8518518518518516,1.3888888888888888,0.4629629629629629,3.7037037037037033,0.9259259259259258,2.7777777777777777,1.3888888888888888
E00183173,185,178,7,5,2,0,0,0,0,96.21621621621622,3.783783783783784,2.7027027027027026,1.0810810810810811,0,0,0,0
E00183174,214,207,4,4,0,2,0,2,1,96.72897196261682,1.8691588785046727,1.8691588785046727,0,0.9345794392523363,0,0.9345794392523363,0.46728971962616817
E00183175,183,178,4,3,1,1,0,1,0,97.26775956284153,2.185792349726776,1.639344262295082,0.546448087431694,0.546448087431694,0,0.546448087431694,0
E00183176,275,271,4,3,1,0,0,0,0,98.54545454545455,1.4545454545454546,1.090909090909091,0.36363636363636365,0,0,0,0
E00183177,247,243,4,4,0,0,0,0,0,98.38056680161942,1.6194331983805668,1.6194331983805668,0,0,0,0,0
E00183178,286,279,5,5,0,2,0,2,0,97.55244755244755,1.7482517482517483,1.7482517482517483,0,0.6993006993006993,0,0.6993006993006993,0
E00183179,377,361,8,8,0,7,3,4,1,95.75596816976127,2.122015915119363,2.122015915119363,0,1.8567639257294428,0.7957559681697612,1.0610079575596816,0.2652519893899204
E00183181,238,224,6,5,1,3,3,0,5,94.11764705882352,2.5210084033613445,2.100840336134454,0.42016806722689076,1.2605042016806722,1.2605042016806722,0,2.100840336134454
E00183183,366,346,11,6,5,8,2,6,1,94.53551912568307,3.0054644808743167,1.639344262295082,1.366120218579235,2.185792349726776,0.546448087431694,1.639344262295082,0.273224043715847
E00183186,186,182,3,3,0,0,0,0,1,97.84946236559139,1.6129032258064515,1.6129032258064515,0,0,0,0,0.5376344086021506
E00183188,282,281,0,0,0,1,1,0,0,99.64539007092199,0,0,0,0.3546099290780142,0.3546099290780142,0,0
E00183189,206,199,5,5,0,1,0,1,1,96.60194174757282,2.4271844660194173,2.4271844660194173,0,0.48543689320388345,0,0.48543689320388345,0.48543689320388345
E00183190,113,98,7,5,2,3,2,1,5,86.72566371681415,6.1946902654867255,4.424778761061947,1.7699115044247788,2.6548672566371683,1.7699115044247788,0.8849557522123894,4.424778761061947
E00183191,243,236,4,1,3,1,0,1,2,97.11934156378601,1.646090534979424,0.411522633744856,1.2345679012345678,0.411522633744856,0,0.411522633744856,0.823045267489712
E00183192,172,163,4,3,1,3,1,2,2,94.76744186046511,2.3255813953488373,1.744186046511628,0.5813953488372093,1.744186046511628,0.5813953488372093,1.1627906976744187,1.1627906976744187
E00183193,248,242,2,1,1,2,1,1,2,97.58064516129032,0.8064516129032258,0.4032258064516129,0.4032258064516129,0.8064516129032258,0.4032258064516129,0.4032258064516129,0.8064516129032258
E00183194,330,315,6,4,2,4,3,1,5,95.45454545454545,1.8181818181818181,1.2121212121212122,0.6060606060606061,1.2121212121212122,0.9090909090909091,0.30303030303030304,1.5151515151515151
E00183195,286,267,6,6,0,3,0,3,10,93.35664335664336,2.097902097902098,2.097902097902098,0,1.048951048951049,0,1.048951048951049,3.4965034965034967
E00183196,190,182,5,5,0,2,0,2,1,95.78947368421052,2.631578947368421,2.631578947368421,0,1.0526315789473684,0,1.0526315789473684,0.5263157894736842
E00183197,227,214,12,5,7,0,0,0,1,94.27312775330397,5.286343612334802,2.2026431718061676,3.0837004405286343,0,0,0,0.4405286343612335
E00183199,224,220,1,0,1,1,0,1,2,98.21428571428571,0.4464285714285714,0,0.4464285714285714,0.4464285714285714,0,0.4464285714285714,0.8928571428571428
E00183200,186,176,6,6,0,4,3,1,0,94.6236559139785,3.225806451612903,3.225806451612903,0,2.1505376344086025,1.6129032258064515,0.5376344086021506,0
E00183201,168,159,5,3,2,2,1,1,2,94.64285714285714,2.976190476190476,1.7857142857142856,1.1904761904761905,1.1904761904761905,0.5952380952380952,0.5952380952380952,1.1904761904761905
E00183202,162,155,3,1,2,3,2,1,1,95.67901234567901,1.8518518518518516,0.6172839506172839,1.2345679012345678,1.8518518518518516,1.2345679012345678,0.6172839506172839,0.6172839506172839
E00183203,198,187,10,6,4,0,0,0,1,94.44444444444444,5.05050505050505,3.0303030303030303,2.0202020202020203,0,0,0,0.5050505050505051
E00183204,260,251,6,5,1,1,1,0,2,96.53846153846153,2.307692307692308,1.9230769230769231,0.38461538461538464,0.38461538461538464,0.38461538461538464,0,0.7692307692307693
E00183205,254,248,4,2,2,2,1,1,0,97.63779527559055,1.574803149606299,0.7874015748031495,0.7874015748031495,0.7874015748031495,0.39370078740157477,0.39370078740157477,0
E00183206,129,120,8,7,1,1,1,0,0,93.02325581395348,6.2015503875969,5.426356589147287,0.7751937984496124,0.7751937984496124,0.7751937984496124,0,0
E00183208,227,221,2,0,2,4,0,4,0,97.3568281938326,0.881057268722467,0,0.881057268722467,1.762114537444934,0,1.762114537444934,0
E00183209,245,236,7,4,3,1,0,1,1,96.3265306122449,2.857142857142857,1.6326530612244898,1.2244897959183674,0.40816326530612246,0,0.40816326530612246,0.40816326530612246
E00183210,634,612,12,12,0,7,3,4,3,96.52996845425868,1.8927444794952681,1.8927444794952681,0,1.1041009463722398,0.47318611987381703,0.6309148264984227,0.47318611987381703
E00183212,291,284,5,4,1,2,1,1,0,97.59450171821305,1.718213058419244,1.3745704467353952,0.3436426116838488,0.6872852233676976,0.3436426116838488,0.3436426116838488,0
E00183213,209,202,2,1,1,4,0,4,1,96.65071770334929,0.9569377990430622,0.4784688995215311,0.4784688995215311,1.9138755980861244,0,1.9138755980861244,0.4784688995215311
E00183214,240,229,3,2,1,2,1,1,6,95.41666666666667,1.25,0.8333333333333334,0.4166666666666667,0.8333333333333334,0.4166666666666667,0.4166666666666667,2.5
E00183217,263,252,7,6,1,4,1,3,0,95.81749049429658,2.6615969581749046,2.2813688212927756,0.38022813688212925,1.520912547528517,0.38022813688212925,1.1406844106463878,0
E00183218,384,378,5,4,1,1,1,0,0,98.4375,1.3020833333333335,1.0416666666666665,0.26041666666666663,0.26041666666666663,0.26041666666666663,0,0
E00183219,294,258,14,4,10,18,2,16,4,87.75510204081633,4.761904761904762,1.3605442176870748,3.4013605442176873,6.122448979591836,0.6802721088435374,5.442176870748299,1.3605442176870748
E00183222,203,200,2,2,0,0,0,0,1,98.52216748768473,0.9852216748768473,0.9852216748768473,0,0,0,0,0.49261083743842365
E00190144,259,254,4,3,1,1,0,1,0,98.06949806949807,1.5444015444015444,1.1583011583011582,0.3861003861003861,0.3861003861003861,0,0.3861003861003861,0
E00190145,283,276,3,3,0,2,1,1,2,97.52650176678446,1.0600706713780919,1.0600706713780919,0,0.7067137809187279,0.35335689045936397,0.35335689045936397,0.7067137809187279
E00190146,233,228,4,2,2,0,0,0,1,97.85407725321889,1.7167381974248928,0.8583690987124464,0.8583690987124464,0,0,0,0.4291845493562232
