OA,ts0390001,ts0390002,ts0390003,ts0390004,ts0390005,ts0390006,ts0390007,ts0390008,ts0390009,ts0390002_PCT,ts0390003_PCT,ts0390004_PCT,ts0390005_PCT,ts0390006_PCT,ts0390007_PCT,ts0390008_PCT,ts0390009_PCT
E00111312,145,122,15,13,2,4,3,1,4,84.13793103448276,10.344827586206897,8.96551724137931,1.3793103448275863,2.7586206896551726,2.0689655172413794,0.6896551724137931,2.7586206896551726
E00111313,215,198,7,5,2,2,2,0,8,92.09302325581396,3.255813953488372,2.3255813953488373,0.9302325581395349,0.9302325581395349,0.9302325581395349,0,3.7209302325581395
E00111314,258,232,15,13,2,5,2,3,6,89.92248062015504,5.813953488372093,5.038759689922481,0.7751937984496124,1.937984496124031,0.7751937984496124,1.1627906976744187,2.3255813953488373
E00111315,340,305,19,15,4,8,6,2,8,89.70588235294117,5.588235294117648,4.411764705882353,1.1764705882352942,2.3529411764705883,1.7647058823529411,0.5882352941176471,2.3529411764705883
E00111316,236,212,10,6,4,4,1,3,10,89.83050847457628,4.23728813559322,2.5423728813559325,1.694915254237288,1.694915254237288,0.423728813559322,1.2711864406779663,4.23728813559322
E00111317,370,331,22,17,5,5,0,5,12,89.45945945945945,5.9459459459459465,4.594594594594595,1.3513513513513513,1.3513513513513513,0,1.3513513513513513,3.2432432432432434
E00111318,367,329,19,14,5,7,4,3,12,89.64577656675749,5.177111716621254,3.8147138964577656,1.3623978201634876,1.9073569482288828,1.08991825613079,0.8174386920980926,3.2697547683923704
E00111319,363,330,21,17,4,7,4,3,5,90.9090909090909,5.785123966942149,4.683195592286501,1.1019283746556474,1.9283746556473829,1.1019283746556474,0.8264462809917356,1.3774104683195594
E00111320,409,380,11,11,0,5,2,3,13,92.90953545232273,2.689486552567237,2.689486552567237,0,1.2224938875305624,0.4889975550122249,0.7334963325183375,3.1784841075794623
E00111321,426,385,23,16,7,7,6,1,11,90.3755868544601,5.39906103286385,3.755868544600939,1.643192488262911,1.643192488262911,1.4084507042253522,0.2347417840375587,2.5821596244131455
E00111322,352,318,13,9,4,9,3,6,12,90.3409090909091,3.6931818181818183,2.556818181818182,1.1363636363636365,2.556818181818182,0.8522727272727272,1.7045454545454544,3.4090909090909087
E00111323,229,212,8,8,0,2,0,2,7,92.57641921397381,3.4934497816593884,3.4934497816593884,0,0.8733624454148471,0,0.8733624454148471,3.056768558951965
E00111324,161,145,4,2,2,3,2,1,9,90.06211180124224,2.484472049689441,1.2422360248447204,1.2422360248447204,1.8633540372670807,1.2422360248447204,0.6211180124223602,5.590062111801243
E00111327,232,205,7,3,4,12,10,2,8,88.36206896551724,3.0172413793103448,1.293103448275862,1.7241379310344827,5.172413793103448,4.310344827586207,0.8620689655172413,3.4482758620689653
E00111328,326,295,15,7,8,8,5,3,8,90.49079754601227,4.601226993865031,2.147239263803681,2.4539877300613497,2.4539877300613497,1.5337423312883436,0.9202453987730062,2.4539877300613497
E00111329,366,335,19,13,6,3,1,2,9,91.53005464480874,5.191256830601093,3.551912568306011,1.639344262295082,0.819672131147541,0.273224043715847,0.546448087431694,2.459016393442623
E00111330,305,276,19,13,6,7,5,2,3,90.49180327868852,6.229508196721312,4.2622950819672125,1.9672131147540985,2.2950819672131146,1.639344262295082,0.6557377049180327,0.9836065573770493
E00111331,298,263,20,15,5,5,3,2,10,88.25503355704699,6.7114093959731544,5.033557046979865,1.6778523489932886,1.6778523489932886,1.006711409395973,0.6711409395973155,3.3557046979865772
E00111332,128,119,6,5,1,1,0,1,2,92.96875,4.6875,3.90625,0.78125,0.78125,0,0.78125,1.5625
E00111333,468,434,18,13,5,8,7,1,8,92.73504273504274,3.8461538461538463,2.7777777777777777,1.0683760683760684,1.7094017094017095,1.4957264957264957,0.2136752136752137,1.7094017094017095
E00111334,430,395,19,15,4,5,3,2,11,91.86046511627907,4.4186046511627906,3.488372093023256,0.9302325581395349,1.1627906976744187,0.6976744186046512,0.46511627906976744,2.558139534883721
E00111335,284,257,9,6,3,1,0,1,17,90.49295774647888,3.169014084507042,2.112676056338028,1.056338028169014,0.35211267605633806,0,0.35211267605633806,5.985915492957746
E00111336,463,426,25,16,9,3,2,1,9,92.0086393088553,5.399568034557236,3.455723542116631,1.9438444924406046,0.6479481641468683,0.4319654427645789,0.21598272138228944,1.9438444924406046
E00111338,305,279,14,10,4,7,3,4,5,91.47540983606557,4.590163934426229,3.278688524590164,1.3114754098360655,2.2950819672131146,0.9836065573770493,1.3114754098360655,1.639344262295082
E00111339,260,239,12,10,2,0,0,0,9,91.92307692307692,4.615384615384616,3.8461538461538463,0.7692307692307693,0,0,0,3.4615384615384617
E00111340,313,290,11,7,4,5,0,5,7,92.65175718849841,3.5143769968051117,2.2364217252396164,1.2779552715654952,1.5974440894568689,0,1.5974440894568689,2.2364217252396164
E00111341,364,318,33,23,10,6,3,3,7,87.36263736263736,9.065934065934066,6.318681318681318,2.7472527472527473,1.6483516483516485,0.8241758241758242,0.8241758241758242,1.9230769230769231
E00111342,353,324,18,14,4,3,0,3,8,91.78470254957507,5.099150141643059,3.9660056657223794,1.13314447592068,0.84985835694051,0,0.84985835694051,2.26628895184136
E00111343,331,297,18,13,5,9,7,2,7,89.72809667673715,5.438066465256798,3.927492447129909,1.5105740181268883,2.719033232628399,2.1148036253776437,0.6042296072507553,2.1148036253776437
E00111344,294,268,14,14,0,7,4,3,5,91.15646258503402,4.761904761904762,4.761904761904762,0,2.380952380952381,1.3605442176870748,1.0204081632653061,1.7006802721088436
E00111345,155,130,7,7,0,5,1,4,13,83.87096774193549,4.516129032258064,4.516129032258064,0,3.225806451612903,0.6451612903225806,2.5806451612903225,8.38709677419355
E00111346,351,298,27,17,10,8,4,4,18,84.9002849002849,7.6923076923076925,4.843304843304843,2.849002849002849,2.2792022792022792,1.1396011396011396,1.1396011396011396,5.128205128205128
E00111347,310,293,12,12,0,2,2,0,3,94.51612903225806,3.870967741935484,3.870967741935484,0,0.6451612903225806,0.6451612903225806,0,0.967741935483871
E00111348,300,280,8,6,2,5,3,2,7,93.33333333333333,2.666666666666667,2,0.6666666666666667,1.6666666666666667,1,0.6666666666666667,2.3333333333333335
E00111349,327,297,19,17,2,3,1,2,8,90.82568807339449,5.81039755351682,5.198776758409786,0.6116207951070336,0.9174311926605505,0.3058103975535168,0.6116207951070336,2.4464831804281344
E00111350,291,272,8,6,2,6,2,4,5,93.47079037800687,2.7491408934707904,2.0618556701030926,0.6872852233676976,2.0618556701030926,0.6872852233676976,1.3745704467353952,1.718213058419244
E00111351,231,208,18,16,2,0,0,0,5,90.04329004329004,7.792207792207792,6.926406926406926,0.8658008658008658,0,0,0,2.1645021645021645
E00111352,233,213,4,1,3,7,3,4,9,91.41630901287554,1.7167381974248928,0.4291845493562232,1.2875536480686696,3.004291845493562,1.2875536480686696,1.7167381974248928,3.862660944206009
E00111353,347,317,24,18,6,5,4,1,1,91.35446685878964,6.9164265129683,5.187319884726225,1.729106628242075,1.440922190201729,1.1527377521613833,0.2881844380403458,0.2881844380403458
E00111354,369,329,17,11,6,8,3,5,15,89.15989159891599,4.607046070460704,2.9810298102981028,1.6260162601626018,2.168021680216802,0.8130081300813009,1.3550135501355014,4.0650406504065035
E00111355,333,308,8,4,4,6,4,2,11,92.49249249249249,2.4024024024024024,1.2012012012012012,1.2012012012012012,1.8018018018018018,1.2012012012012012,0.6006006006006006,3.303303303303303
E00111356,207,192,4,2,2,4,2,2,7,92.7536231884058,1.932367149758454,0.966183574879227,0.966183574879227,1.932367149758454,0.966183574879227,0.966183574879227,3.3816425120772946
E00111357,284,254,15,8,7,7,6,1,8,89.43661971830986,5.28169014084507,2.8169014084507045,2.464788732394366,2.464788732394366,2.112676056338028,0.35211267605633806,2.8169014084507045
E00111358,394,358,17,13,4,11,7,4,8,90.86294416243655,4.314720812182741,3.2994923857868024,1.015228426395939,2.7918781725888326,1.7766497461928936,1.015228426395939,2.030456852791878
E00111360,268,247,12,7,5,5,3,2,4,92.16417910447761,4.477611940298507,2.6119402985074625,1.8656716417910446,1.8656716417910446,1.1194029850746268,0.7462686567164178,1.4925373134328357
E00111361,337,301,20,17,3,7,6,1,9,89.31750741839762,5.934718100890208,5.044510385756676,0.8902077151335311,2.0771513353115725,1.7804154302670623,0.2967359050445104,2.6706231454005933
E00111362,352,308,23,15,8,9,1,8,12,87.5,6.534090909090909,4.261363636363636,2.272727272727273,2.556818181818182,0.2840909090909091,2.272727272727273,3.4090909090909087
E00111363,359,336,18,16,2,4,4,0,1,93.59331476323119,5.013927576601671,4.456824512534819,0.5571030640668524,1.1142061281337048,1.1142061281337048,0,0.2785515320334262
E00111364,274,255,10,8,2,4,2,2,5,93.06569343065694,3.64963503649635,2.9197080291970803,0.7299270072992701,1.4598540145985401,0.7299270072992701,0.7299270072992701,1.824817518248175
E00111365,307,289,11,7,4,0,0,0,7,94.13680781758957,3.5830618892508146,2.2801302931596092,1.3029315960912053,0,0,0,2.2801302931596092
E00111366,312,289,7,5,2,4,2,2,12,92.62820512820514,2.2435897435897436,1.6025641025641024,0.641025641025641,1.282051282051282,0.641025641025641,0.641025641025641,3.8461538461538463
E00111367,266,235,16,13,3,2,0,2,13,88.34586466165413,6.015037593984962,4.887218045112782,1.1278195488721803,0.7518796992481203,0,0.7518796992481203,4.887218045112782
E00111368,292,273,10,8,2,4,2,2,5,93.4931506849315,3.4246575342465753,2.73972602739726,0.684931506849315,1.36986301369863,0.684931506849315,0.684931506849315,1.7123287671232876
E00111369,342,312,18,13,5,5,3,2,7,91.22807017543859,5.263157894736842,3.8011695906432745,1.461988304093567,1.461988304093567,0.8771929824561403,0.5847953216374269,2.046783625730994
E00111370,362,327,24,19,5,4,4,0,7,90.33149171270718,6.629834254143646,5.248618784530387,1.3812154696132597,1.1049723756906076,1.1049723756906076,0,1.9337016574585635
E00111371,245,219,11,10,1,5,3,2,10,89.38775510204081,4.489795918367347,4.081632653061225,0.40816326530612246,2.0408163265306123,1.2244897959183674,0.8163265306122449,4.081632653061225
E00111372,300,272,16,8,8,2,1,1,10,90.66666666666666,5.333333333333334,2.666666666666667,2.666666666666667,0.6666666666666667,0.33333333333333337,0.33333333333333337,3.3333333333333335
E00111373,271,246,12,10,2,3,1,2,10,90.7749077490775,4.428044280442804,3.6900369003690034,0.7380073800738007,1.107011070110701,0.36900369003690037,0.7380073800738007,3.6900369003690034
E00111374,220,193,15,13,2,4,2,2,8,87.72727272727273,6.8181818181818175,5.909090909090909,0.9090909090909091,1.8181818181818181,0.9090909090909091,0.9090909090909091,3.6363636363636362
E00111375,355,325,16,9,7,6,5,1,8,91.54929577464789,4.507042253521127,2.535211267605634,1.971830985915493,1.6901408450704223,1.4084507042253522,0.28169014084507044,2.2535211267605635
E00111376,470,432,16,9,7,5,5,0,17,91.91489361702128,3.404255319148936,1.9148936170212765,1.4893617021276597,1.0638297872340425,1.0638297872340425,0,3.6170212765957444
E00111377,303,268,20,17,3,4,2,2,11,88.44884488448845,6.6006600660066,5.6105610561056105,0.9900990099009901,1.3201320132013201,0.6600660066006601,0.6600660066006601,3.6303630363036308
E00111378,328,297,20,13,7,3,1,2,8,90.54878048780488,6.097560975609756,3.9634146341463414,2.1341463414634148,0.9146341463414633,0.3048780487804878,0.6097560975609756,2.4390243902439024
E00111379,338,304,21,15,6,7,2,5,6,89.94082840236686,6.21301775147929,4.437869822485207,1.7751479289940828,2.0710059171597637,0.591715976331361,1.4792899408284024,1.7751479289940828
E00111380,219,206,10,7,3,1,1,0,2,94.06392694063926,4.5662100456621,3.1963470319634704,1.36986301369863,0.45662100456621,0.45662100456621,0,0.91324200913242
E00111381,281,261,10,9,1,1,1,0,9,92.88256227758008,3.558718861209965,3.202846975088968,0.3558718861209964,0.3558718861209964,0.3558718861209964,0,3.202846975088968
E00111382,312,279,17,14,3,5,2,3,11,89.42307692307693,5.448717948717949,4.487179487179487,0.9615384615384616,1.6025641025641024,0.641025641025641,0.9615384615384616,3.5256410256410255
E00111383,309,289,12,8,4,2,1,1,6,93.52750809061489,3.8834951456310676,2.5889967637540456,1.2944983818770228,0.6472491909385114,0.3236245954692557,0.3236245954692557,1.9417475728155338
E00111384,341,325,8,6,2,3,1,2,5,95.30791788856305,2.346041055718475,1.7595307917888565,0.5865102639296188,0.8797653958944283,0.2932551319648094,0.5865102639296188,1.466275659824047
E00111385,361,319,27,21,6,1,1,0,14,88.36565096952909,7.479224376731302,5.8171745152354575,1.662049861495845,0.2770083102493075,0.2770083102493075,0,3.8781163434903045
E00111386,262,237,16,11,5,2,0,2,7,90.45801526717557,6.106870229007633,4.198473282442748,1.9083969465648856,0.7633587786259541,0,0.7633587786259541,2.6717557251908395
E00111387,255,231,17,11,6,3,3,0,4,90.58823529411765,6.666666666666667,4.313725490196078,2.3529411764705883,1.1764705882352942,1.1764705882352942,0,1.5686274509803921
E00111388,279,250,12,11,1,3,2,1,14,89.6057347670251,4.301075268817205,3.942652329749104,0.35842293906810035,1.0752688172043012,0.7168458781362007,0.35842293906810035,5.017921146953405
E00111389,288,269,10,8,2,4,4,0,5,93.40277777777779,3.4722222222222223,2.7777777777777777,0.6944444444444444,1.3888888888888888,1.3888888888888888,0,1.7361111111111112
E00111390,157,146,6,4,2,4,2,2,1,92.99363057324841,3.821656050955414,2.547770700636943,1.2738853503184715,2.547770700636943,1.2738853503184715,1.2738853503184715,0.6369426751592357
E00111391,301,284,12,7,5,0,0,0,5,94.35215946843853,3.9867109634551494,2.3255813953488373,1.6611295681063125,0,0,0,1.6611295681063125
E00111392,271,248,12,9,3,5,3,2,6,91.5129151291513,4.428044280442804,3.3210332103321036,1.107011070110701,1.8450184501845017,1.107011070110701,0.7380073800738007,2.214022140221402
E00111393,303,264,27,17,10,6,2,4,6,87.12871287128714,8.91089108910891,5.6105610561056105,3.3003300330033,1.9801980198019802,0.6600660066006601,1.3201320132013201,1.9801980198019802
E00111394,352,316,22,15,7,3,0,3,11,89.77272727272727,6.25,4.261363636363636,1.9886363636363635,0.8522727272727272,0,0.8522727272727272,3.125
E00111395,264,238,16,12,4,4,1,3,6,90.15151515151516,6.0606060606060606,4.545454545454546,1.5151515151515151,1.5151515151515151,0.3787878787878788,1.1363636363636365,2.272727272727273
E00111396,291,261,11,8,3,9,5,4,10,89.69072164948454,3.7800687285223367,2.7491408934707904,1.0309278350515463,3.0927835051546393,1.718213058419244,1.3745704467353952,3.436426116838488
E00111397,247,227,16,13,3,1,0,1,3,91.90283400809717,6.477732793522267,5.263157894736842,1.214574898785425,0.4048582995951417,0,0.4048582995951417,1.214574898785425
E00111398,266,243,13,4,9,4,3,1,6,91.35338345864662,4.887218045112782,1.5037593984962405,3.3834586466165413,1.5037593984962405,1.1278195488721803,0.37593984962406013,2.2556390977443606
E00111399,234,217,5,3,2,3,1,2,9,92.73504273504274,2.1367521367521367,1.282051282051282,0.8547008547008548,1.282051282051282,0.4273504273504274,0.8547008547008548,3.8461538461538463
E00111400,366,330,15,8,7,6,2,4,15,90.1639344262295,4.098360655737705,2.185792349726776,1.912568306010929,1.639344262295082,0.546448087431694,1.092896174863388,4.098360655737705
E00111401,201,172,16,10,6,8,3,5,5,85.57213930348259,7.960199004975125,4.975124378109453,2.9850746268656714,3.9800995024875623,1.4925373134328357,2.4875621890547266,2.4875621890547266
E00111402,397,371,16,11,5,1,0,1,9,93.45088161209067,4.030226700251889,2.770780856423174,1.2594458438287155,0.2518891687657431,0,0.2518891687657431,2.2670025188916876
E00111403,290,266,12,10,2,2,0,2,10,91.72413793103448,4.137931034482759,3.4482758620689653,0.6896551724137931,0.6896551724137931,0,0.6896551724137931,3.4482758620689653
E00111404,315,275,20,15,5,9,7,2,11,87.3015873015873,6.349206349206349,4.761904761904762,1.5873015873015872,2.857142857142857,2.2222222222222223,0.6349206349206349,3.492063492063492
E00111405,298,268,16,9,7,5,2,3,9,89.93288590604027,5.369127516778524,3.0201342281879198,2.348993288590604,1.6778523489932886,0.6711409395973155,1.006711409395973,3.0201342281879198
E00111406,278,252,14,6,8,4,0,4,8,90.64748201438849,5.0359712230215825,2.158273381294964,2.877697841726619,1.4388489208633095,0,1.4388489208633095,2.877697841726619
E00111407,335,303,26,19,7,3,0,3,3,90.44776119402985,7.761194029850746,5.6716417910447765,2.0895522388059704,0.8955223880597015,0,0.8955223880597015,0.8955223880597015
E00111408,301,259,25,16,9,5,2,3,12,86.04651162790698,8.305647840531561,5.3156146179401995,2.990033222591362,1.6611295681063125,0.6644518272425249,0.9966777408637874,3.9867109634551494
E00111410,317,285,15,14,1,8,6,2,9,89.90536277602523,4.73186119873817,4.416403785488959,0.31545741324921134,2.5236593059936907,1.8927444794952681,0.6309148264984227,2.8391167192429023
E00111412,336,308,20,16,4,3,1,2,5,91.66666666666666,5.952380952380952,4.761904761904762,1.1904761904761905,0.8928571428571428,0.2976190476190476,0.5952380952380952,1.488095238095238
E00111413,340,322,9,9,0,7,3,4,2,94.70588235294117,2.6470588235294117,2.6470588235294117,0,2.0588235294117645,0.8823529411764706,1.1764705882352942,0.5882352941176471
E00111414,349,320,22,17,5,1,1,0,6,91.69054441260745,6.303724928366762,4.871060171919771,1.4326647564469914,0.28653295128939826,0.28653295128939826,0,1.7191977077363898
E00111415,250,222,17,11,6,1,0,1,10,88.8,6.800000000000001,4.3999999999999995,2.4,0.4,0,0.4,4
E00111416,246,219,15,10,5,4,1,3,8,89.02439024390245,6.097560975609756,4.0650406504065035,2.0325203252032518,1.6260162601626018,0.40650406504065045,1.2195121951219512,3.2520325203252036
E00111417,315,280,19,16,3,8,4,4,8,88.88888888888889,6.031746031746032,5.079365079365079,0.9523809523809524,2.5396825396825395,1.2698412698412698,1.2698412698412698,2.5396825396825395
E00111418,288,272,10,9,1,3,3,0,3,94.44444444444444,3.4722222222222223,3.125,0.3472222222222222,1.0416666666666665,1.0416666666666665,0,1.0416666666666665
E00111419,389,366,15,10,5,4,2,2,4,94.08740359897172,3.8560411311053984,2.570694087403599,1.2853470437017995,1.0282776349614395,0.5141388174807198,0.5141388174807198,1.0282776349614395
E00111420,273,257,4,3,1,6,1,5,6,94.13919413919413,1.465201465201465,1.098901098901099,0.3663003663003663,2.197802197802198,0.3663003663003663,1.8315018315018317,2.197802197802198
E00111421,282,260,13,11,2,3,2,1,6,92.19858156028369,4.609929078014184,3.900709219858156,0.7092198581560284,1.0638297872340425,0.7092198581560284,0.3546099290780142,2.127659574468085
E00111422,284,265,9,9,0,3,1,2,7,93.30985915492957,3.169014084507042,3.169014084507042,0,1.056338028169014,0.35211267605633806,0.7042253521126761,2.464788732394366
E00111423,289,261,17,16,1,4,2,2,7,90.3114186851211,5.88235294117647,5.536332179930796,0.34602076124567477,1.384083044982699,0.6920415224913495,0.6920415224913495,2.422145328719723
E00111424,242,230,9,8,1,0,0,0,3,95.0413223140496,3.71900826446281,3.3057851239669422,0.4132231404958678,0,0,0,1.2396694214876034
E00111425,192,180,3,1,2,3,1,2,6,93.75,1.5625,0.5208333333333333,1.0416666666666665,1.5625,0.5208333333333333,1.0416666666666665,3.125
E00111426,287,259,20,18,2,4,1,3,4,90.2439024390244,6.968641114982578,6.2717770034843205,0.6968641114982579,1.3937282229965158,0.34843205574912894,1.0452961672473868,1.3937282229965158
E00111427,180,161,8,6,2,0,0,0,11,89.44444444444444,4.444444444444445,3.3333333333333335,1.1111111111111112,0,0,0,6.111111111111111
E00111428,299,260,23,18,5,6,4,2,10,86.95652173913044,7.6923076923076925,6.0200668896321075,1.6722408026755853,2.0066889632107023,1.3377926421404682,0.6688963210702341,3.3444816053511706
E00111429,273,241,15,12,3,6,2,4,11,88.27838827838828,5.4945054945054945,4.395604395604396,1.098901098901099,2.197802197802198,0.7326007326007326,1.465201465201465,4.029304029304029
E00111430,282,265,16,14,2,0,0,0,1,93.97163120567376,5.673758865248227,4.964539007092199,0.7092198581560284,0,0,0,0.3546099290780142
E00111431,247,231,8,8,0,4,2,2,4,93.52226720647774,3.2388663967611335,3.2388663967611335,0,1.6194331983805668,0.8097165991902834,0.8097165991902834,1.6194331983805668
E00111432,299,261,19,15,4,5,3,2,14,87.29096989966555,6.354515050167224,5.016722408026756,1.3377926421404682,1.6722408026755853,1.0033444816053512,0.6688963210702341,4.682274247491638
E00111433,296,268,22,18,4,2,2,0,4,90.54054054054053,7.4324324324324325,6.081081081081082,1.3513513513513513,0.6756756756756757,0.6756756756756757,0,1.3513513513513513
E00111434,318,278,20,16,4,5,5,0,15,87.42138364779875,6.289308176100629,5.031446540880504,1.257861635220126,1.5723270440251573,1.5723270440251573,0,4.716981132075472
E00111435,337,308,16,13,3,3,2,1,10,91.3946587537092,4.747774480712167,3.857566765578635,0.8902077151335311,0.8902077151335311,0.5934718100890208,0.2967359050445104,2.967359050445104
E00111436,262,238,7,4,3,10,2,8,7,90.83969465648855,2.6717557251908395,1.5267175572519083,1.1450381679389312,3.816793893129771,0.7633587786259541,3.0534351145038165,2.6717557251908395
E00111437,253,234,10,8,2,0,0,0,9,92.4901185770751,3.9525691699604746,3.1620553359683794,0.7905138339920948,0,0,0,3.557312252964427
E00111438,318,288,15,11,4,3,1,2,12,90.56603773584906,4.716981132075472,3.459119496855346,1.257861635220126,0.9433962264150944,0.3144654088050315,0.628930817610063,3.7735849056603774
E00111439,267,236,19,16,3,2,0,2,10,88.38951310861424,7.116104868913857,5.992509363295881,1.1235955056179776,0.7490636704119851,0,0.7490636704119851,3.7453183520599254
E00111440,499,457,28,21,7,6,2,4,8,91.58316633266533,5.61122244488978,4.208416833667335,1.402805611222445,1.2024048096192386,0.4008016032064128,0.8016032064128256,1.6032064128256511
E00111441,268,237,17,11,6,11,9,2,3,88.43283582089553,6.343283582089552,4.104477611940299,2.2388059701492535,4.104477611940299,3.3582089552238807,0.7462686567164178,1.1194029850746268
E00111442,301,268,15,9,6,4,3,1,14,89.03654485049833,4.983388704318937,2.990033222591362,1.9933554817275747,1.3289036544850499,0.9966777408637874,0.33222591362126247,4.651162790697675
E00111443,310,291,11,10,1,3,0,3,5,93.87096774193549,3.5483870967741935,3.225806451612903,0.3225806451612903,0.967741935483871,0,0.967741935483871,1.6129032258064515
E00111444,322,299,11,9,2,2,0,2,10,92.85714285714286,3.4161490683229814,2.7950310559006213,0.6211180124223602,0.6211180124223602,0,0.6211180124223602,3.1055900621118013
E00111445,439,417,10,8,2,7,2,5,5,94.98861047835992,2.277904328018223,1.8223234624145785,0.45558086560364464,1.5945330296127564,0.45558086560364464,1.1389521640091116,1.1389521640091116
E00111446,340,310,17,12,5,5,0,5,8,91.17647058823529,5,3.5294117647058822,1.4705882352941175,1.4705882352941175,0,1.4705882352941175,2.3529411764705883
E00111447,443,404,26,19,7,5,2,3,8,91.19638826185101,5.8690744920993225,4.288939051918736,1.580135440180587,1.1286681715575622,0.4514672686230248,0.6772009029345373,1.805869074492099
E00111448,344,322,10,10,0,6,5,1,6,93.6046511627907,2.9069767441860463,2.9069767441860463,0,1.744186046511628,1.4534883720930232,0.29069767441860467,1.744186046511628
E00111449,360,335,13,8,5,8,5,3,4,93.05555555555556,3.6111111111111107,2.2222222222222223,1.3888888888888888,2.2222222222222223,1.3888888888888888,0.8333333333333334,1.1111111111111112
E00111450,313,284,14,10,4,5,2,3,10,90.73482428115017,4.472843450479233,3.1948881789137378,1.2779552715654952,1.5974440894568689,0.6389776357827476,0.9584664536741214,3.1948881789137378
E00111451,285,259,17,16,1,3,2,1,6,90.87719298245615,5.964912280701754,5.614035087719298,0.3508771929824561,1.0526315789473684,0.7017543859649122,0.3508771929824561,2.1052631578947367
E00111452,341,302,20,15,5,8,5,3,11,88.56304985337243,5.865102639296188,4.398826979472141,1.466275659824047,2.346041055718475,1.466275659824047,0.8797653958944283,3.225806451612903
E00111453,330,297,11,9,2,6,5,1,16,90,3.3333333333333335,2.727272727272727,0.6060606060606061,1.8181818181818181,1.5151515151515151,0.30303030303030304,4.848484848484849
E00111454,322,281,20,13,7,8,4,4,13,87.26708074534162,6.211180124223603,4.037267080745342,2.1739130434782608,2.484472049689441,1.2422360248447204,1.2422360248447204,4.037267080745342
E00111455,200,172,14,6,8,2,2,0,12,86,7.000000000000001,3,4,1,1,0,6
E00111456,217,202,8,6,2,1,0,1,6,93.08755760368663,3.686635944700461,2.7649769585253456,0.9216589861751152,0.4608294930875576,0,0.4608294930875576,2.7649769585253456
E00111457,294,265,20,13,7,3,3,0,6,90.1360544217687,6.802721088435375,4.421768707482993,2.380952380952381,1.0204081632653061,1.0204081632653061,0,2.0408163265306123
E00111458,119,106,5,4,1,5,4,1,3,89.07563025210085,4.201680672268908,3.361344537815126,0.8403361344537815,4.201680672268908,3.361344537815126,0.8403361344537815,2.5210084033613445
E00111459,329,307,14,11,3,4,3,1,4,93.3130699088146,4.25531914893617,3.343465045592705,0.911854103343465,1.21580547112462,0.911854103343465,0.303951367781155,1.21580547112462
E00111460,258,234,13,9,4,2,0,2,9,90.69767441860465,5.038759689922481,3.488372093023256,1.550387596899225,0.7751937984496124,0,0.7751937984496124,3.488372093023256
E00111461,250,215,15,13,2,8,5,3,12,86,6,5.2,0.8,3.2,2,1.2,4.8
E00111462,201,178,8,4,4,5,4,1,10,88.55721393034825,3.9800995024875623,1.9900497512437811,1.9900497512437811,2.4875621890547266,1.9900497512437811,0.4975124378109453,4.975124378109453
E00111463,249,224,9,6,3,9,4,5,7,89.95983935742971,3.614457831325301,2.4096385542168677,1.2048192771084338,3.614457831325301,1.6064257028112447,2.0080321285140563,2.8112449799196786
E00111464,348,326,19,14,5,2,0,2,1,93.67816091954023,5.459770114942529,4.022988505747127,1.4367816091954022,0.5747126436781609,0,0.5747126436781609,0.28735632183908044
E00111465,315,293,7,4,3,4,3,1,11,93.01587301587301,2.2222222222222223,1.2698412698412698,0.9523809523809524,1.2698412698412698,0.9523809523809524,0.31746031746031744,3.492063492063492
E00111466,323,298,14,7,7,2,1,1,9,92.26006191950464,4.3343653250774,2.1671826625387,2.1671826625387,0.6191950464396285,0.30959752321981426,0.30959752321981426,2.786377708978328
E00111467,291,268,16,14,2,3,2,1,4,92.09621993127148,5.498281786941581,4.810996563573884,0.6872852233676976,1.0309278350515463,0.6872852233676976,0.3436426116838488,1.3745704467353952
E00111468,333,307,15,10,5,2,2,0,9,92.1921921921922,4.504504504504505,3.003003003003003,1.5015015015015014,0.6006006006006006,0.6006006006006006,0,2.7027027027027026
E00111469,308,277,13,8,5,9,5,4,9,89.93506493506493,4.220779220779221,2.5974025974025974,1.6233766233766231,2.922077922077922,1.6233766233766231,1.2987012987012987,2.922077922077922
E00111470,370,347,13,11,2,4,2,2,6,93.78378378378378,3.5135135135135136,2.9729729729729732,0.5405405405405406,1.0810810810810811,0.5405405405405406,0.5405405405405406,1.6216216216216217
E00111471,401,356,31,27,4,6,3,3,8,88.7780548628429,7.73067331670823,6.733167082294264,0.997506234413965,1.4962593516209477,0.7481296758104738,0.7481296758104738,1.99501246882793
E00111472,326,300,17,11,6,5,3,2,4,92.02453987730061,5.214723926380368,3.374233128834356,1.8404907975460123,1.5337423312883436,0.9202453987730062,0.6134969325153374,1.2269938650306749
E00111473,319,291,14,10,4,4,2,2,10,91.22257053291536,4.38871473354232,3.1347962382445136,1.2539184952978055,1.2539184952978055,0.6269592476489028,0.6269592476489028,3.1347962382445136
E00111474,287,257,14,10,4,6,2,4,10,89.54703832752612,4.878048780487805,3.484320557491289,1.3937282229965158,2.0905923344947737,0.6968641114982579,1.3937282229965158,3.484320557491289
E00111475,319,288,20,16,4,1,1,0,10,90.28213166144201,6.269592476489027,5.015673981191222,1.2539184952978055,0.3134796238244514,0.3134796238244514,0,3.1347962382445136
E00111476,325,306,13,8,5,1,1,0,5,94.15384615384616,4,2.4615384615384617,1.5384615384615385,0.3076923076923077,0.3076923076923077,0,1.5384615384615385
E00111477,250,225,15,13,2,4,1,3,6,90,6,5.2,0.8,1.6,0.4,1.2,2.4
E00111478,379,346,23,20,3,6,4,2,4,91.2928759894459,6.068601583113456,5.277044854881266,0.79155672823219,1.58311345646438,1.0554089709762533,0.5277044854881267,1.0554089709762533
E00111479,318,283,22,16,6,5,3,2,8,88.9937106918239,6.918238993710692,5.031446540880504,1.8867924528301887,1.5723270440251573,0.9433962264150944,0.628930817610063,2.515723270440252
E00111480,289,273,9,7,2,3,2,1,4,94.4636678200692,3.1141868512110724,2.422145328719723,0.6920415224913495,1.0380622837370241,0.6920415224913495,0.34602076124567477,1.384083044982699
E00111481,311,281,13,7,6,9,6,3,8,90.35369774919614,4.180064308681672,2.2508038585209005,1.929260450160772,2.8938906752411575,1.929260450160772,0.964630225080386,2.572347266881029
E00111482,279,254,15,14,1,2,0,2,8,91.0394265232975,5.376344086021505,5.017921146953405,0.35842293906810035,0.7168458781362007,0,0.7168458781362007,2.867383512544803
E00111483,289,259,17,15,2,3,1,2,10,89.61937716262976,5.88235294117647,5.190311418685121,0.6920415224913495,1.0380622837370241,0.34602076124567477,0.6920415224913495,3.4602076124567476
E00111484,304,269,18,12,6,10,4,6,7,88.48684210526315,5.921052631578947,3.9473684210526314,1.9736842105263157,3.289473684210526,1.3157894736842104,1.9736842105263157,2.302631578947368
E00111485,232,220,7,3,4,1,1,0,4,94.82758620689656,3.0172413793103448,1.293103448275862,1.7241379310344827,0.43103448275862066,0.43103448275862066,0,1.7241379310344827
E00111486,318,299,12,9,3,5,3,2,2,94.0251572327044,3.7735849056603774,2.8301886792452833,0.9433962264150944,1.5723270440251573,0.9433962264150944,0.628930817610063,0.628930817610063
E00111487,250,226,13,9,4,5,5,0,6,90.4,5.2,3.5999999999999996,1.6,2,2,0,2.4
E00111488,264,233,18,15,3,5,1,4,8,88.25757575757575,6.8181818181818175,5.681818181818182,1.1363636363636365,1.893939393939394,0.3787878787878788,1.5151515151515151,3.0303030303030303
E00111489,226,204,7,5,2,6,4,2,9,90.2654867256637,3.0973451327433628,2.2123893805309733,0.8849557522123894,2.6548672566371683,1.7699115044247788,0.8849557522123894,3.982300884955752
E00111490,331,305,18,13,5,1,1,0,7,92.14501510574019,5.438066465256798,3.927492447129909,1.5105740181268883,0.3021148036253776,0.3021148036253776,0,2.1148036253776437
E00111491,305,272,24,20,4,2,1,1,7,89.18032786885246,7.868852459016394,6.557377049180328,1.3114754098360655,0.6557377049180327,0.32786885245901637,0.32786885245901637,2.2950819672131146
E00111492,322,281,22,18,4,3,3,0,16,87.26708074534162,6.832298136645963,5.590062111801243,1.2422360248447204,0.9316770186335404,0.9316770186335404,0,4.968944099378882
E00111493,249,226,12,8,4,4,1,3,7,90.76305220883533,4.819277108433735,3.2128514056224895,1.6064257028112447,1.6064257028112447,0.4016064257028112,1.2048192771084338,2.8112449799196786
E00111494,309,291,9,7,2,4,1,3,5,94.1747572815534,2.912621359223301,2.26537216828479,0.6472491909385114,1.2944983818770228,0.3236245954692557,0.9708737864077669,1.6181229773462782
E00111495,326,294,15,10,5,10,3,7,7,90.1840490797546,4.601226993865031,3.067484662576687,1.5337423312883436,3.067484662576687,0.9202453987730062,2.147239263803681,2.147239263803681
E00111496,266,247,12,7,5,4,2,2,3,92.85714285714286,4.511278195488721,2.631578947368421,1.8796992481203008,1.5037593984962405,0.7518796992481203,0.7518796992481203,1.1278195488721803
E00111497,327,300,14,11,3,4,3,1,9,91.74311926605505,4.281345565749235,3.3639143730886847,0.9174311926605505,1.2232415902140672,0.9174311926605505,0.3058103975535168,2.7522935779816518
E00111499,261,234,18,13,5,4,3,1,5,89.65517241379311,6.896551724137931,4.980842911877394,1.9157088122605364,1.532567049808429,1.1494252873563218,0.38314176245210724,1.9157088122605364
E00111500,280,256,8,5,3,6,2,4,10,91.42857142857143,2.857142857142857,1.7857142857142856,1.0714285714285714,2.142857142857143,0.7142857142857143,1.4285714285714286,3.571428571428571
E00111501,230,207,10,8,2,4,2,2,9,90,4.3478260869565215,3.4782608695652173,0.8695652173913043,1.7391304347826086,0.8695652173913043,0.8695652173913043,3.91304347826087
E00111503,267,247,7,4,3,5,4,1,8,92.50936329588015,2.6217228464419478,1.4981273408239701,1.1235955056179776,1.8726591760299627,1.4981273408239701,0.37453183520599254,2.9962546816479403
E00111505,285,254,14,10,4,10,7,3,7,89.12280701754386,4.912280701754386,3.508771929824561,1.4035087719298245,3.508771929824561,2.456140350877193,1.0526315789473684,2.456140350877193
E00111506,254,231,12,5,7,4,0,4,7,90.94488188976378,4.724409448818897,1.968503937007874,2.7559055118110236,1.574803149606299,0,1.574803149606299,2.7559055118110236
E00111507,292,268,13,9,4,5,2,3,6,91.78082191780823,4.4520547945205475,3.0821917808219177,1.36986301369863,1.7123287671232876,0.684931506849315,1.0273972602739725,2.054794520547945
E00111508,284,249,21,13,8,2,2,0,12,87.67605633802818,7.394366197183098,4.577464788732395,2.8169014084507045,0.7042253521126761,0.7042253521126761,0,4.225352112676056
E00111509,282,251,18,15,3,4,2,2,9,89.00709219858156,6.382978723404255,5.319148936170213,1.0638297872340425,1.4184397163120568,0.7092198581560284,0.7092198581560284,3.1914893617021276
E00111510,158,140,7,4,3,4,2,2,7,88.60759493670885,4.430379746835443,2.5316455696202533,1.89873417721519,2.5316455696202533,1.2658227848101267,1.2658227848101267,4.430379746835443
E00111511,287,261,16,15,1,6,3,3,4,90.94076655052264,5.574912891986063,5.2264808362369335,0.34843205574912894,2.0905923344947737,1.0452961672473868,1.0452961672473868,1.3937282229965158
E00111512,281,257,12,9,3,4,3,1,8,91.45907473309609,4.270462633451958,3.202846975088968,1.0676156583629894,1.4234875444839856,1.0676156583629894,0.3558718861209964,2.8469750889679712
E00111513,279,249,18,11,7,7,6,1,5,89.24731182795699,6.451612903225806,3.942652329749104,2.5089605734767026,2.5089605734767026,2.1505376344086025,0.35842293906810035,1.7921146953405016
E00111514,290,252,12,10,2,17,6,11,9,86.89655172413792,4.137931034482759,3.4482758620689653,0.6896551724137931,5.862068965517241,2.0689655172413794,3.793103448275862,3.103448275862069
E00111515,342,315,15,11,4,7,4,3,5,92.10526315789474,4.385964912280701,3.216374269005848,1.1695906432748537,2.046783625730994,1.1695906432748537,0.8771929824561403,1.461988304093567
E00111516,246,223,10,9,1,6,3,3,7,90.65040650406505,4.0650406504065035,3.6585365853658534,0.40650406504065045,2.4390243902439024,1.2195121951219512,1.2195121951219512,2.8455284552845526
E00111517,336,288,28,20,8,4,1,3,16,85.71428571428571,8.333333333333332,5.952380952380952,2.380952380952381,1.1904761904761905,0.2976190476190476,0.8928571428571428,4.761904761904762
E00111518,316,288,11,8,3,8,5,3,9,91.13924050632912,3.481012658227848,2.5316455696202533,0.949367088607595,2.5316455696202533,1.5822784810126582,0.949367088607595,2.848101265822785
E00111519,268,243,15,10,5,3,3,0,7,90.67164179104478,5.597014925373134,3.731343283582089,1.8656716417910446,1.1194029850746268,1.1194029850746268,0,2.6119402985074625
E00111520,244,229,8,7,1,3,3,0,4,93.85245901639344,3.278688524590164,2.8688524590163933,0.4098360655737705,1.2295081967213115,1.2295081967213115,0,1.639344262295082
E00111521,332,310,7,5,2,5,3,2,10,93.37349397590361,2.108433734939759,1.5060240963855422,0.6024096385542169,1.5060240963855422,0.9036144578313252,0.6024096385542169,3.0120481927710845
E00111522,257,237,16,12,4,0,0,0,4,92.21789883268482,6.22568093385214,4.669260700389105,1.556420233463035,0,0,0,1.556420233463035
E00111523,527,496,9,7,2,8,6,2,14,94.11764705882352,1.7077798861480076,1.3282732447817838,0.3795066413662239,1.5180265654648957,1.1385199240986716,0.3795066413662239,2.6565464895635675
E00111524,291,267,17,14,3,1,1,0,6,91.75257731958763,5.841924398625429,4.810996563573884,1.0309278350515463,0.3436426116838488,0.3436426116838488,0,2.0618556701030926
E00111525,299,269,14,10,4,4,1,3,12,89.96655518394648,4.682274247491638,3.3444816053511706,1.3377926421404682,1.3377926421404682,0.33444816053511706,1.0033444816053512,4.013377926421405
E00111526,301,284,13,10,3,1,0,1,3,94.35215946843853,4.318936877076411,3.322259136212625,0.9966777408637874,0.33222591362126247,0,0.33222591362126247,0.9966777408637874
E00111527,291,268,12,8,4,4,2,2,7,92.09621993127148,4.123711340206185,2.7491408934707904,1.3745704467353952,1.3745704467353952,0.6872852233676976,0.6872852233676976,2.405498281786942
E00111528,317,277,15,9,6,8,3,5,17,87.38170347003155,4.73186119873817,2.8391167192429023,1.8927444794952681,2.5236593059936907,0.9463722397476341,1.5772870662460567,5.3627760252365935
E00111529,290,271,14,13,1,0,0,0,5,93.44827586206897,4.827586206896552,4.482758620689655,0.3448275862068966,0,0,0,1.7241379310344827
E00111530,289,273,11,10,1,0,0,0,5,94.4636678200692,3.8062283737024223,3.4602076124567476,0.34602076124567477,0,0,0,1.7301038062283738
E00111531,232,209,12,9,3,3,2,1,8,90.08620689655173,5.172413793103448,3.8793103448275863,1.293103448275862,1.293103448275862,0.8620689655172413,0.43103448275862066,3.4482758620689653
E00111532,255,227,9,5,4,8,3,5,11,89.01960784313725,3.5294117647058822,1.9607843137254901,1.5686274509803921,3.1372549019607843,1.1764705882352942,1.9607843137254901,4.313725490196078
E00111533,387,360,23,19,4,1,1,0,3,93.02325581395348,5.943152454780361,4.909560723514212,1.03359173126615,0.2583979328165375,0.2583979328165375,0,0.7751937984496124
E00111534,257,241,10,7,3,3,0,3,3,93.77431906614785,3.8910505836575875,2.7237354085603114,1.1673151750972763,1.1673151750972763,0,1.1673151750972763,1.1673151750972763
E00111535,306,282,11,10,1,6,4,2,7,92.15686274509804,3.594771241830065,3.2679738562091507,0.32679738562091504,1.9607843137254901,1.3071895424836601,0.6535947712418301,2.287581699346405
E00111536,314,285,15,13,2,7,5,2,7,90.76433121019109,4.777070063694268,4.140127388535031,0.6369426751592357,2.229299363057325,1.5923566878980893,0.6369426751592357,2.229299363057325
E00111537,407,364,32,22,10,5,0,5,6,89.43488943488943,7.862407862407863,5.405405405405405,2.457002457002457,1.2285012285012284,0,1.2285012285012284,1.4742014742014742
E00111538,332,315,9,7,2,3,3,0,5,94.87951807228916,2.710843373493976,2.108433734939759,0.6024096385542169,0.9036144578313252,0.9036144578313252,0,1.5060240963855422
E00111539,289,269,13,9,4,2,2,0,5,93.07958477508652,4.498269896193772,3.1141868512110724,1.384083044982699,0.6920415224913495,0.6920415224913495,0,1.7301038062283738
E00111540,323,289,23,19,4,1,1,0,10,89.47368421052632,7.120743034055728,5.88235294117647,1.238390092879257,0.30959752321981426,0.30959752321981426,0,3.0959752321981426
E00111541,340,320,12,7,5,4,2,2,4,94.11764705882352,3.5294117647058822,2.0588235294117645,1.4705882352941175,1.1764705882352942,0.5882352941176471,0.5882352941176471,1.1764705882352942
E00111542,341,319,9,5,4,5,4,1,8,93.54838709677419,2.6392961876832843,1.466275659824047,1.1730205278592376,1.466275659824047,1.1730205278592376,0.2932551319648094,2.346041055718475
E00111543,301,280,8,3,5,6,3,3,7,93.02325581395348,2.6578073089700998,0.9966777408637874,1.6611295681063125,1.9933554817275747,0.9966777408637874,0.9966777408637874,2.3255813953488373
E00111544,271,239,16,12,4,7,3,4,9,88.19188191881919,5.904059040590406,4.428044280442804,1.4760147601476015,2.5830258302583027,1.107011070110701,1.4760147601476015,3.3210332103321036
E00111545,241,216,15,6,9,6,4,2,4,89.62655601659752,6.224066390041494,2.4896265560165975,3.7344398340248963,2.4896265560165975,1.6597510373443984,0.8298755186721992,1.6597510373443984
E00111546,332,314,11,9,2,4,3,1,3,94.57831325301204,3.313253012048193,2.710843373493976,0.6024096385542169,1.2048192771084338,0.9036144578313252,0.30120481927710846,0.9036144578313252
E00111547,291,271,9,7,2,2,0,2,9,93.12714776632302,3.0927835051546393,2.405498281786942,0.6872852233676976,0.6872852233676976,0,0.6872852233676976,3.0927835051546393
E00111548,351,322,16,13,3,4,2,2,9,91.73789173789174,4.5584045584045585,3.7037037037037033,0.8547008547008548,1.1396011396011396,0.5698005698005698,0.5698005698005698,2.564102564102564
E00111549,263,233,13,7,6,9,2,7,8,88.59315589353612,4.942965779467681,2.6615969581749046,2.2813688212927756,3.4220532319391634,0.7604562737642585,2.6615969581749046,3.041825095057034
E00111550,306,273,19,14,5,5,2,3,9,89.2156862745098,6.209150326797386,4.57516339869281,1.6339869281045754,1.6339869281045754,0.6535947712418301,0.9803921568627451,2.941176470588235
E00111551,309,277,21,14,7,7,6,1,4,89.64401294498381,6.796116504854369,4.53074433656958,2.26537216828479,2.26537216828479,1.9417475728155338,0.3236245954692557,1.2944983818770228
E00111552,300,272,13,8,5,3,2,1,12,90.66666666666666,4.333333333333334,2.666666666666667,1.6666666666666667,1,0.6666666666666667,0.33333333333333337,4
E00111553,329,298,19,13,6,1,1,0,11,90.5775075987842,5.775075987841945,3.951367781155015,1.82370820668693,0.303951367781155,0.303951367781155,0,3.343465045592705
E00111554,334,302,20,15,5,8,3,5,4,90.41916167664671,5.9880239520958085,4.491017964071856,1.4970059880239521,2.3952095808383236,0.8982035928143712,1.4970059880239521,1.1976047904191618
E00111555,346,326,12,12,0,1,0,1,7,94.21965317919076,3.4682080924855487,3.4682080924855487,0,0.2890173410404624,0,0.2890173410404624,2.023121387283237
E00111556,254,229,13,9,4,3,1,2,9,90.15748031496062,5.118110236220472,3.543307086614173,1.574803149606299,1.1811023622047243,0.39370078740157477,0.7874015748031495,3.543307086614173
E00111557,287,271,8,8,0,3,2,1,5,94.42508710801394,2.7874564459930316,2.7874564459930316,0,1.0452961672473868,0.6968641114982579,0.34843205574912894,1.7421602787456445
E00111558,373,349,17,13,4,3,3,0,4,93.5656836461126,4.557640750670242,3.485254691689008,1.0723860589812333,0.8042895442359249,0.8042895442359249,0,1.0723860589812333
E00111559,264,237,11,8,3,2,1,1,14,89.77272727272727,4.166666666666666,3.0303030303030303,1.1363636363636365,0.7575757575757576,0.3787878787878788,0.3787878787878788,5.303030303030303
E00111560,315,283,14,9,5,7,3,4,11,89.84126984126985,4.444444444444445,2.857142857142857,1.5873015873015872,2.2222222222222223,0.9523809523809524,1.2698412698412698,3.492063492063492
E00111561,261,240,13,8,5,0,0,0,8,91.95402298850574,4.980842911877394,3.065134099616858,1.9157088122605364,0,0,0,3.065134099616858
E00111562,343,318,16,11,5,3,2,1,6,92.71137026239067,4.664723032069971,3.206997084548105,1.4577259475218658,0.8746355685131195,0.5830903790087464,0.2915451895043732,1.749271137026239
E00111563,210,196,6,5,1,2,2,0,6,93.33333333333333,2.857142857142857,2.380952380952381,0.4761904761904762,0.9523809523809524,0.9523809523809524,0,2.857142857142857
E00111564,308,282,18,12,6,1,1,0,7,91.55844155844156,5.844155844155844,3.896103896103896,1.948051948051948,0.3246753246753247,0.3246753246753247,0,2.272727272727273
E00111565,190,175,7,5,2,3,0,3,5,92.10526315789474,3.684210526315789,2.631578947368421,1.0526315789473684,1.5789473684210527,0,1.5789473684210527,2.631578947368421
E00111566,346,317,15,8,7,3,1,2,11,91.61849710982659,4.335260115606936,2.312138728323699,2.023121387283237,0.8670520231213872,0.2890173410404624,0.5780346820809248,3.1791907514450863
E00111567,309,270,15,13,2,6,1,5,18,87.37864077669903,4.854368932038835,4.207119741100324,0.6472491909385114,1.9417475728155338,0.3236245954692557,1.6181229773462782,5.825242718446602
E00111568,329,305,16,8,8,2,1,1,6,92.70516717325228,4.86322188449848,2.43161094224924,2.43161094224924,0.60790273556231,0.303951367781155,0.303951367781155,1.82370820668693
E00111569,296,267,18,14,4,3,2,1,8,90.2027027027027,6.081081081081082,4.72972972972973,1.3513513513513513,1.0135135135135136,0.6756756756756757,0.33783783783783783,2.7027027027027026
E00111570,398,366,17,15,2,7,6,1,8,91.95979899497488,4.271356783919598,3.7688442211055273,0.5025125628140703,1.7587939698492463,1.507537688442211,0.25125628140703515,2.0100502512562812
E00111571,275,252,9,5,4,7,2,5,7,91.63636363636364,3.272727272727273,1.8181818181818181,1.4545454545454546,2.5454545454545454,0.7272727272727273,1.8181818181818181,2.5454545454545454
E00111572,346,313,24,19,5,5,0,5,4,90.46242774566474,6.9364161849710975,5.491329479768786,1.4450867052023122,1.4450867052023122,0,1.4450867052023122,1.1560693641618496
E00170004,270,254,10,8,2,2,1,1,4,94.07407407407408,3.7037037037037033,2.9629629629629632,0.7407407407407408,0.7407407407407408,0.3703703703703704,0.3703703703703704,1.4814814814814816
E00170005,301,273,19,14,5,4,0,4,5,90.69767441860465,6.312292358803987,4.651162790697675,1.6611295681063125,1.3289036544850499,0,1.3289036544850499,1.6611295681063125
E00170006,310,287,19,14,5,1,0,1,3,92.58064516129032,6.129032258064516,4.516129032258064,1.6129032258064515,0.3225806451612903,0,0.3225806451612903,0.967741935483871
E00170007,123,112,6,3,3,2,1,1,3,91.05691056910568,4.878048780487805,2.4390243902439024,2.4390243902439024,1.6260162601626018,0.8130081300813009,0.8130081300813009,2.4390243902439024
E00170008,158,147,7,4,3,4,2,2,0,93.0379746835443,4.430379746835443,2.5316455696202533,1.89873417721519,2.5316455696202533,1.2658227848101267,1.2658227848101267,0
E00170009,129,118,3,3,0,5,3,2,3,91.47286821705426,2.3255813953488373,2.3255813953488373,0,3.875968992248062,2.3255813953488373,1.550387596899225,2.3255813953488373
E00180459,498,458,19,17,2,7,4,3,14,91.96787148594377,3.815261044176707,3.413654618473896,0.4016064257028112,1.4056224899598393,0.8032128514056224,0.6024096385542169,2.8112449799196786
E00180468,322,291,12,9,3,9,6,3,10,90.37267080745342,3.7267080745341614,2.7950310559006213,0.9316770186335404,2.7950310559006213,1.8633540372670807,0.9316770186335404,3.1055900621118013
E00180497,257,235,11,8,3,4,4,0,7,91.43968871595331,4.280155642023346,3.11284046692607,1.1673151750972763,1.556420233463035,1.556420233463035,0,2.7237354085603114
E00180509,155,140,6,6,0,1,1,0,8,90.32258064516128,3.870967741935484,3.870967741935484,0,0.6451612903225806,0.6451612903225806,0,5.161290322580645
E00180512,362,332,14,10,4,6,2,4,10,91.71270718232044,3.867403314917127,2.7624309392265194,1.1049723756906076,1.6574585635359116,0.5524861878453038,1.1049723756906076,2.7624309392265194
E00180522,519,494,10,7,3,7,1,6,8,95.18304431599229,1.9267822736030826,1.348747591522158,0.5780346820809248,1.348747591522158,0.1926782273603083,1.1560693641618496,1.5414258188824663
E00180523,467,433,15,13,2,8,2,6,11,92.71948608137045,3.2119914346895073,2.7837259100642395,0.4282655246252677,1.7130620985010707,0.4282655246252677,1.284796573875803,2.355460385438972
E00180530,122,115,3,3,0,0,0,0,4,94.26229508196722,2.459016393442623,2.459016393442623,0,0,0,0,3.278688524590164
E00180537,281,259,11,8,3,4,0,4,7,92.17081850533808,3.9145907473309607,2.8469750889679712,1.0676156583629894,1.4234875444839856,0,1.4234875444839856,2.491103202846975
E00180539,337,306,12,10,2,8,5,3,11,90.80118694362018,3.5608308605341246,2.967359050445104,0.5934718100890208,2.3738872403560833,1.483679525222552,0.8902077151335311,3.2640949554896146
E00180541,560,505,33,20,13,5,1,4,17,90.17857142857143,5.892857142857142,3.571428571428571,2.3214285714285716,0.8928571428571428,0.17857142857142858,0.7142857142857143,3.0357142857142856
E00180547,138,126,9,7,2,1,1,0,2,91.30434782608695,6.521739130434782,5.072463768115942,1.4492753623188406,0.7246376811594203,0.7246376811594203,0,1.4492753623188406
E00180549,299,286,11,8,3,2,0,2,0,95.65217391304348,3.678929765886288,2.6755852842809364,1.0033444816053512,0.6688963210702341,0,0.6688963210702341,0
